movieYear,gross,budget,imdbScore,profit,genres
2016,330249062,250000000,6.9,80249062,Action
2016,330249062,250000000,6.9,80249062,Adventure
2016,330249062,250000000,6.9,80249062,Sci-Fi
2016,407197282,250000000,8.2,157197282,Action
2016,407197282,250000000,8.2,157197282,Adventure
2016,407197282,250000000,8.2,157197282,Sci-Fi
2016,130468626,185000000,7.5,-54531374,Action
2016,130468626,185000000,7.5,-54531374,Adventure
2016,130468626,185000000,7.5,-54531374,Sci-Fi
2016,130468626,185000000,7.5,-54531374,Thriller
2016,124051759,180000000,6.6,-55948241,Action
2016,124051759,180000000,6.6,-55948241,Adventure
2016,124051759,180000000,6.6,-55948241,Drama
2016,124051759,180000000,6.6,-55948241,Romance
2016,154985087,178000000,7.3,-23014913,Action
2016,154985087,178000000,7.3,-23014913,Adventure
2016,154985087,178000000,7.3,-23014913,Sci-Fi
2016,161087183,175000000,6.9,-13912817,Action
2016,161087183,175000000,6.9,-13912817,Adventure
2016,161087183,175000000,6.9,-13912817,Comedy
2016,161087183,175000000,6.9,-13912817,Sci-Fi
2016,362645141,175000000,7.8,187645141,Adventure
2016,362645141,175000000,7.8,187645141,Drama
2016,362645141,175000000,7.8,187645141,Family
2016,362645141,175000000,7.8,187645141,Fantasy
2016,102315545,165000000,5.5,-62684455,Action
2016,102315545,165000000,5.5,-62684455,Adventure
2016,102315545,165000000,5.5,-62684455,Sci-Fi
2016,76846624,170000000,6.4,-93153376,Adventure
2016,76846624,170000000,6.4,-93153376,Family
2016,76846624,170000000,6.4,-93153376,Fantasy
2016,46978995,160000000,7.3,-113021005,Action
2016,46978995,160000000,7.3,-113021005,Adventure
2016,46978995,160000000,7.3,-113021005,Fantasy
2016,124051759,180000000,6.6,-55948241,Action
2016,124051759,180000000,6.6,-55948241,Adventure
2016,124051759,180000000,6.6,-55948241,Drama
2016,124051759,180000000,6.6,-55948241,Romance
2016,118099659,144000000,5.5,-25900341,Action
2016,118099659,144000000,5.5,-25900341,Comedy
2016,118099659,144000000,5.5,-25900341,Fantasy
2016,118099659,144000000,5.5,-25900341,Sci-Fi
2016,143523463,145000000,7.2,-1476537,Action
2016,143523463,145000000,7.2,-1476537,Adventure
2016,143523463,145000000,7.2,-1476537,Animation
2016,143523463,145000000,7.2,-1476537,Comedy
2016,143523463,145000000,7.2,-1476537,Family
2016,31141074,140000000,5.5,-108858926,Action
2016,31141074,140000000,5.5,-108858926,Adventure
2016,31141074,140000000,5.5,-108858926,Fantasy
2016,52792307,140000000,6.8,-87207693,Adventure
2016,52792307,140000000,6.8,-87207693,Family
2016,52792307,140000000,6.8,-87207693,Fantasy
2016,108521835,120000000,7.1,-11478165,Action
2016,108521835,120000000,7.1,-11478165,Thriller
2016,47952020,115000000,6.1,-67047980,Action
2016,47952020,115000000,6.1,-67047980,Adventure
2016,47952020,115000000,6.1,-67047980,Drama
2016,47952020,115000000,6.1,-67047980,Fantasy
2016,81638674,135000000,6.3,-53361326,Action
2016,81638674,135000000,6.3,-53361326,Adventure
2016,81638674,135000000,6.3,-53361326,Comedy
2016,81638674,135000000,6.3,-53361326,Sci-Fi
2016,66002193,110000000,5.8,-43997807,Action
2016,66002193,110000000,5.8,-43997807,Adventure
2016,66002193,110000000,5.8,-43997807,Mystery
2016,66002193,110000000,5.8,-43997807,Sci-Fi
2016,66002193,110000000,5.8,-43997807,Thriller
2016,64685359,90000000,6.9,-25314641,Action
2016,64685359,90000000,6.9,-25314641,Adventure
2016,64685359,90000000,6.9,-25314641,Comedy
2016,64685359,90000000,6.9,-25314641,Crime
2016,64685359,90000000,6.9,-25314641,Mystery
2016,64685359,90000000,6.9,-25314641,Thriller
2016,323505540,75000000,6.8,248505540,Animation
2016,323505540,75000000,6.8,248505540,Comedy
2016,323505540,75000000,6.8,248505540,Family
2016,107225164,73000000,6.3,34225164,Action
2016,107225164,73000000,6.3,34225164,Animation
2016,107225164,73000000,6.3,34225164,Comedy
2016,107225164,73000000,6.3,34225164,Family
2016,62401264,60000000,5.9,2401264,Action
2016,62401264,60000000,5.9,2401264,Crime
2016,62401264,60000000,5.9,2401264,Drama
2016,62401264,60000000,5.9,2401264,Thriller
2016,363024263,58000000,8.1,305024263,Action
2016,363024263,58000000,8.1,305024263,Adventure
2016,363024263,58000000,8.1,305024263,Comedy
2016,363024263,58000000,8.1,305024263,Romance
2016,363024263,58000000,8.1,305024263,Sci-Fi
2016,126088877,50000000,6.6,76088877,Action
2016,126088877,50000000,6.6,76088877,Comedy
2016,126088877,50000000,6.6,76088877,Crime
2016,52822418,50000000,7.4,2822418,Action
2016,52822418,50000000,7.4,2822418,Drama
2016,52822418,50000000,7.4,2822418,Thriller
2016,52822418,50000000,7.4,2822418,War
2016,20389967,50000000,6.7,-29610033,Action
2016,20389967,50000000,6.7,-29610033,Biography
2016,20389967,50000000,6.7,-29610033,Drama
2016,20389967,50000000,6.7,-29610033,History
2016,20389967,50000000,6.7,-29610033,War
2016,28837115,50000000,4.8,-21162885,Comedy
2016,14946229,25000000,7.3,-10053771,Biography
2016,14946229,25000000,7.3,-10053771,Crime
2016,14946229,25000000,7.3,-10053771,Drama
2016,14946229,25000000,7.3,-10053771,Thriller
2016,102310175,40000000,7.8,62310175,Horror
2016,102310175,40000000,7.8,62310175,Mystery
2016,102310175,40000000,7.8,62310175,Thriller
2016,90835030,40000000,5.9,50835030,Action
2016,90835030,40000000,5.9,50835030,Comedy
2016,34912982,38000000,5.2,-3087018,Action
2016,34912982,38000000,5.2,-3087018,Adventure
2016,34912982,38000000,5.2,-3087018,Sci-Fi
2016,34912982,38000000,5.2,-3087018,Thriller
2016,46813366,38000000,6.1,8813366,Comedy
2016,46813366,38000000,6.1,8813366,Romance
2016,55291815,35000000,6,20291815,Comedy
2016,14268533,31500000,6.3,-17231467,Action
2016,14268533,31500000,6.3,-17231467,Crime
2016,14268533,31500000,6.3,-17231467,Drama
2016,14268533,31500000,6.3,-17231467,Mystery
2016,14268533,31500000,6.3,-17231467,Sci-Fi
2016,14268533,31500000,6.3,-17231467,Thriller
2016,118099659,144000000,5.5,-25900341,Action
2016,118099659,144000000,5.5,-25900341,Comedy
2016,118099659,144000000,5.5,-25900341,Fantasy
2016,118099659,144000000,5.5,-25900341,Sci-Fi
2016,63034755,29000000,5.3,34034755,Comedy
2016,10907291,28000000,5.8,-17092709,Action
2016,10907291,28000000,5.8,-17092709,Horror
2016,10907291,28000000,5.8,-17092709,Romance
2016,362645141,175000000,7.8,187645141,Adventure
2016,362645141,175000000,7.8,187645141,Drama
2016,362645141,175000000,7.8,187645141,Family
2016,362645141,175000000,7.8,187645141,Fantasy
2016,41008532,27000000,6.7,14008532,Crime
2016,41008532,27000000,6.7,14008532,Drama
2016,41008532,27000000,6.7,14008532,Thriller
2016,15785632,23000000,7.5,-7214368,Biography
2016,15785632,23000000,7.5,-7214368,Comedy
2016,15785632,23000000,7.5,-7214368,Drama
2016,15785632,23000000,7.5,-7214368,Sport
2016,1512815,25000000,5.8,-23487185,Action
2016,1512815,25000000,5.8,-23487185,Drama
2016,1512815,25000000,5.8,-23487185,Western
2016,15785632,23000000,7.5,-7214368,Biography
2016,15785632,23000000,7.5,-7214368,Comedy
2016,15785632,23000000,7.5,-7214368,Drama
2016,15785632,23000000,7.5,-7214368,Sport
2016,29997095,22000000,6.4,7997095,Comedy
2016,29997095,22000000,6.4,7997095,Mystery
2016,56154094,20000000,7.6,36154094,Drama
2016,56154094,20000000,7.6,36154094,Romance
2016,55461307,20000000,6.7,35461307,Comedy
2016,36874745,20000000,6.3,16874745,Action
2016,36874745,20000000,6.3,16874745,Adventure
2016,36874745,20000000,6.3,16874745,Drama
2016,36874745,20000000,6.3,16874745,Mystery
2016,28876924,20000000,7.1,8876924,Adventure
2016,28876924,20000000,7.1,8876924,Crime
2016,28876924,20000000,7.1,8876924,Mystery
2016,28876924,20000000,7.1,8876924,Sci-Fi
2016,28876924,20000000,7.1,8876924,Thriller
2016,12626905,20000000,6.3,-7373095,Action
2016,12626905,20000000,6.3,-7373095,Crime
2016,12626905,20000000,6.3,-7373095,Drama
2016,12626905,20000000,6.3,-7373095,Thriller
2016,59573085,18000000,6.1,41573085,Comedy
2016,59573085,18000000,6.1,41573085,Family
2016,59573085,18000000,6.1,41573085,Romance
2016,3707794,18000000,6.7,-14292206,Adventure
2016,3707794,18000000,6.7,-14292206,Drama
2016,3707794,18000000,6.7,-14292206,Sci-Fi
2016,3707794,18000000,6.7,-14292206,Thriller
2016,6462576,18500000,5.4,-12037424,Drama
2016,55461307,20000000,6.7,35461307,Comedy
2016,20566327,15000000,6.4,5566327,Action
2016,20566327,15000000,6.4,5566327,Comedy
2016,61693523,13000000,6.8,48693523,Drama
2016,54257433,17000000,6.8,37257433,Drama
2016,54257433,17000000,6.8,37257433,Horror
2016,54257433,17000000,6.8,37257433,Thriller
2016,31662,12620000,6.8,-12588338,Action
2016,31662,12620000,6.8,-12588338,Drama
2016,31662,12620000,6.8,-12588338,History
2016,31662,12620000,6.8,-12588338,War
2016,35537564,11500000,6,24037564,Comedy
2016,78845130,10000000,6.1,68845130,Action
2016,78845130,10000000,6.1,68845130,Horror
2016,78845130,10000000,6.1,68845130,Sci-Fi
2016,78845130,10000000,6.1,68845130,Thriller
2016,35794166,10000000,6,25794166,Horror
2016,35794166,10000000,6,25794166,Mystery
2016,35794166,10000000,6,25794166,Thriller
2016,26583369,10000000,4.8,16583369,Horror
2016,26583369,10000000,4.8,16583369,Mystery
2016,26583369,10000000,4.8,16583369,Thriller
2016,1330827,7000000,7,-5669173,Horror
2016,1330827,7000000,7,-5669173,Thriller
2016,71897215,15000000,7.3,56897215,Drama
2016,71897215,15000000,7.3,56897215,Horror
2016,71897215,15000000,7.3,56897215,Mystery
2016,71897215,15000000,7.3,56897215,Sci-Fi
2016,71897215,15000000,7.3,56897215,Thriller
2016,56536016,4900000,6.9,51636016,Horror
2016,11675178,5000000,3.5,6675178,Comedy
2016,9658370,5000000,4.5,4658370,Comedy
2016,9658370,5000000,4.5,4658370,Romance
2016,123777,3500000,4.7,-3376223,Action
2016,123777,3500000,4.7,-3376223,Biography
2016,123777,3500000,4.7,-3376223,Crime
2016,123777,3500000,4.7,-3376223,Drama
2016,123777,3500000,4.7,-3376223,Family
2016,123777,3500000,4.7,-3376223,Fantasy
2016,3105269,3000000,5,105269,Action
2016,3105269,3000000,5,105269,Comedy
2016,20773070,5000000,3.4,15773070,Drama
2015,200074175,245000000,6.8,-44925825,Action
2015,200074175,245000000,6.8,-44925825,Adventure
2015,200074175,245000000,6.8,-44925825,Thriller
2015,458991599,250000000,7.5,208991599,Action
2015,458991599,250000000,7.5,208991599,Adventure
2015,458991599,250000000,7.5,208991599,Sci-Fi
2015,652177271,150000000,7,502177271,Action
2015,652177271,150000000,7,502177271,Adventure
2015,652177271,150000000,7,502177271,Sci-Fi
2015,652177271,150000000,7,502177271,Thriller
2015,350034110,190000000,7.2,160034110,Action
2015,350034110,190000000,7.2,160034110,Crime
2015,350034110,190000000,7.2,160034110,Thriller
2015,47375327,176000000,5.4,-128624673,Action
2015,47375327,176000000,5.4,-128624673,Adventure
2015,47375327,176000000,5.4,-128624673,Sci-Fi
2015,356454367,175000000,8.3,181454367,Adventure
2015,356454367,175000000,8.3,181454367,Animation
2015,356454367,175000000,8.3,181454367,Comedy
2015,356454367,175000000,8.3,181454367,Drama
2015,356454367,175000000,8.3,181454367,Family
2015,356454367,175000000,8.3,181454367,Fantasy
2015,93417865,190000000,6.5,-96582135,Action
2015,93417865,190000000,6.5,-96582135,Adventure
2015,93417865,190000000,6.5,-96582135,Family
2015,93417865,190000000,6.5,-96582135,Mystery
2015,93417865,190000000,6.5,-96582135,Sci-Fi
2015,281666058,160000000,6.6,121666058,Adventure
2015,281666058,160000000,6.6,121666058,Sci-Fi
2015,89732035,155000000,6.6,-65267965,Action
2015,89732035,155000000,6.6,-65267965,Adventure
2015,89732035,155000000,6.6,-65267965,Sci-Fi
2015,153629485,150000000,8.1,3629485,Action
2015,153629485,150000000,8.1,3629485,Adventure
2015,153629485,150000000,8.1,3629485,Sci-Fi
2015,153629485,150000000,8.1,3629485,Thriller
2015,195000874,150000000,7.4,45000874,Action
2015,195000874,150000000,7.4,45000874,Adventure
2015,195000874,150000000,7.4,45000874,Thriller
2015,34964818,150000000,5.8,-115035182,Adventure
2015,34964818,150000000,5.8,-115035182,Family
2015,34964818,150000000,5.8,-115035182,Fantasy
2015,183635922,135000000,8.1,48635922,Adventure
2015,183635922,135000000,8.1,48635922,Drama
2015,183635922,135000000,8.1,48635922,Thriller
2015,183635922,135000000,8.1,48635922,Western
2015,180191634,130000000,7.4,50191634,Action
2015,180191634,130000000,7.4,50191634,Adventure
2015,180191634,130000000,7.4,50191634,Comedy
2015,180191634,130000000,7.4,50191634,Sci-Fi
2015,177343675,135000000,6.7,42343675,Adventure
2015,177343675,135000000,6.7,42343675,Animation
2015,177343675,135000000,6.7,42343675,Comedy
2015,177343675,135000000,6.7,42343675,Family
2015,177343675,135000000,6.7,42343675,Fantasy
2015,177343675,135000000,6.7,42343675,Sci-Fi
2015,56114221,120000000,4.3,-63885779,Action
2015,56114221,120000000,4.3,-63885779,Adventure
2015,56114221,120000000,4.3,-63885779,Sci-Fi
2015,155181732,110000000,6.1,45181732,Action
2015,155181732,110000000,6.1,45181732,Adventure
2015,155181732,110000000,6.1,45181732,Drama
2015,155181732,110000000,6.1,45181732,Thriller
2015,129995817,110000000,6.3,19995817,Adventure
2015,129995817,110000000,6.3,19995817,Sci-Fi
2015,129995817,110000000,6.3,19995817,Thriller
2015,228430993,108000000,8.1,120430993,Adventure
2015,228430993,108000000,8.1,120430993,Drama
2015,228430993,108000000,8.1,120430993,Sci-Fi
2015,34964818,150000000,5.8,-115035182,Adventure
2015,34964818,150000000,5.8,-115035182,Family
2015,34964818,150000000,5.8,-115035182,Fantasy
2015,28772222,105000000,5.3,-76227778,Action
2015,28772222,105000000,5.3,-76227778,Crime
2015,28772222,105000000,5.3,-76227778,Sport
2015,28772222,105000000,5.3,-76227778,Thriller
2015,24985612,100000000,7,-75014388,Action
2015,24985612,100000000,7,-75014388,Adventure
2015,24985612,100000000,7,-75014388,Biography
2015,24985612,100000000,7,-75014388,Drama
2015,24985612,100000000,7,-75014388,History
2015,24985612,100000000,7,-75014388,Thriller
2015,130174897,99000000,7.2,31174897,Adventure
2015,130174897,99000000,7.2,31174897,Animation
2015,130174897,99000000,7.2,31174897,Comedy
2015,130174897,99000000,7.2,31174897,Family
2015,201148159,95000000,7,106148159,Drama
2015,201148159,95000000,7,106148159,Family
2015,201148159,95000000,7,106148159,Fantasy
2015,201148159,95000000,7,106148159,Romance
2015,85884815,90000000,5,-4115185,Adventure
2015,85884815,90000000,5,-4115185,Animation
2015,85884815,90000000,5,-4115185,Comedy
2015,85884815,90000000,5,-4115185,Family
2015,85884815,90000000,5,-4115185,Fantasy
2015,85884815,90000000,5,-4115185,Music
2015,78747585,88000000,5.6,-9252415,Action
2015,78747585,88000000,5.6,-9252415,Animation
2015,78747585,88000000,5.6,-9252415,Comedy
2015,78747585,88000000,5.6,-9252415,Sci-Fi
2015,56114221,120000000,4.3,-63885779,Action
2015,56114221,120000000,4.3,-63885779,Adventure
2015,56114221,120000000,4.3,-63885779,Sci-Fi
2015,169692572,80000000,6.7,89692572,Animation
2015,169692572,80000000,6.7,89692572,Comedy
2015,169692572,80000000,6.7,89692572,Family
2015,169692572,80000000,6.7,89692572,Fantasy
2015,27356090,90000000,6,-62643910,Action
2015,27356090,90000000,6,-62643910,Adventure
2015,27356090,90000000,6,-62643910,Fantasy
2015,1339152,81200000,7.8,-79860848,Adventure
2015,1339152,81200000,7.8,-79860848,Animation
2015,1339152,81200000,7.8,-79860848,Drama
2015,1339152,81200000,7.8,-79860848,Family
2015,1339152,81200000,7.8,-79860848,Fantasy
2015,45434443,75000000,7.3,-29565557,Action
2015,45434443,75000000,7.3,-29565557,Adventure
2015,45434443,75000000,7.3,-29565557,Comedy
2015,336029560,74000000,6.4,262029560,Action
2015,336029560,74000000,6.4,262029560,Animation
2015,336029560,74000000,6.4,262029560,Comedy
2015,336029560,74000000,6.4,262029560,Family
2015,336029560,74000000,6.4,262029560,Sci-Fi
2015,162495848,74000000,6,88495848,Adventure
2015,162495848,74000000,6,88495848,Animation
2015,162495848,74000000,6,88495848,Comedy
2015,162495848,74000000,6,88495848,Family
2015,162495848,74000000,6,88495848,Fantasy
2015,7097125,70000000,5.4,-62902875,Action
2015,7097125,70000000,5.4,-62902875,Crime
2015,7097125,70000000,5.4,-62902875,Drama
2015,7097125,70000000,5.4,-62902875,Mystery
2015,7097125,70000000,5.4,-62902875,Thriller
2015,81257500,68000000,6.4,13257500,Comedy
2015,53846915,50100000,6.6,3746915,Comedy
2015,53846915,50100000,6.6,3746915,Crime
2015,53846915,50100000,6.6,3746915,Drama
2015,53846915,50100000,6.6,3746915,Romance
2015,43247140,55000000,7.1,-11752860,Adventure
2015,43247140,55000000,7.1,-11752860,Biography
2015,43247140,55000000,7.1,-11752860,Drama
2015,43247140,55000000,7.1,-11752860,History
2015,43247140,55000000,7.1,-11752860,Sport
2015,43247140,55000000,7.1,-11752860,Thriller
2015,72413,65000000,6.1,-64927587,Action
2015,72413,65000000,6.1,-64927587,Adventure
2015,72413,65000000,6.1,-64927587,Drama
2015,72413,65000000,6.1,-64927587,History
2015,54116191,44000000,7.9,10116191,Crime
2015,54116191,44000000,7.9,10116191,Drama
2015,54116191,44000000,7.9,10116191,Mystery
2015,54116191,44000000,7.9,10116191,Thriller
2015,54116191,44000000,7.9,10116191,Western
2015,81687587,61000000,6.4,20687587,Action
2015,81687587,61000000,6.4,20687587,Sci-Fi
2015,81687587,61000000,6.4,20687587,Thriller
2015,56443482,60000000,6.6,-3556518,Biography
2015,56443482,60000000,6.6,-3556518,Comedy
2015,56443482,60000000,6.6,-3556518,Drama
2015,7605668,60000000,5.5,-52394332,Action
2015,7605668,60000000,5.5,-52394332,Comedy
2015,7605668,60000000,5.5,-52394332,Mystery
2015,7605668,60000000,5.5,-52394332,Romance
2015,80021740,58000000,6.4,22021740,Adventure
2015,80021740,58000000,6.4,22021740,Comedy
2015,80021740,58000000,6.4,22021740,Family
2015,80021740,58000000,6.4,22021740,Fantasy
2015,80021740,58000000,6.4,22021740,Horror
2015,62563543,53000000,7,9563543,Biography
2015,62563543,53000000,7,9563543,Crime
2015,62563543,53000000,7,9563543,Drama
2015,150315155,50000000,6.1,100315155,Comedy
2015,150315155,50000000,6.1,100315155,Family
2015,26442251,50000000,6.6,-23557749,Action
2015,26442251,50000000,6.6,-23557749,Crime
2015,26442251,50000000,6.6,-23557749,Drama
2015,26442251,50000000,6.6,-23557749,Thriller
2015,31569268,49000000,6.9,-17430732,Action
2015,31569268,49000000,6.9,-17430732,Crime
2015,31569268,49000000,6.9,-17430732,Drama
2015,31569268,49000000,6.9,-17430732,Sci-Fi
2015,31569268,49000000,6.9,-17430732,Thriller
2015,1206135,50000000,6.4,-48793865,Crime
2015,1206135,50000000,6.4,-48793865,Drama
2015,1206135,50000000,6.4,-48793865,Thriller
2015,5773519,40000000,6,-34226481,Drama
2015,5773519,40000000,6,-34226481,Horror
2015,5773519,40000000,6,-34226481,Sci-Fi
2015,5773519,40000000,6,-34226481,Thriller
2015,166147885,40000000,4.1,126147885,Drama
2015,166147885,40000000,4.1,126147885,Romance
2015,90353764,40000000,6,50353764,Comedy
2015,90353764,40000000,6,50353764,Crime
2015,75274748,35000000,7.2,40274748,Comedy
2015,75274748,35000000,7.2,40274748,Drama
2015,72306065,40000000,7.6,32306065,Drama
2015,72306065,40000000,7.6,32306065,History
2015,72306065,40000000,7.6,32306065,Thriller
2015,5773519,40000000,6,-34226481,Drama
2015,5773519,40000000,6,-34226481,Horror
2015,5773519,40000000,6,-34226481,Sci-Fi
2015,5773519,40000000,6,-34226481,Thriller
2015,10640645,40000000,5.8,-29359355,Action
2015,10640645,40000000,5.8,-29359355,Crime
2015,10640645,40000000,5.8,-29359355,Drama
2015,10640645,40000000,5.8,-29359355,Mystery
2015,10640645,40000000,5.8,-29359355,Thriller
2015,6498000,18026148,8.4,-11528148,Action
2015,6498000,18026148,8.4,-11528148,Adventure
2015,6498000,18026148,8.4,-11528148,Drama
2015,6498000,18026148,8.4,-11528148,Fantasy
2015,6498000,18026148,8.4,-11528148,War
2015,71038190,30000000,4.4,41038190,Action
2015,71038190,30000000,4.4,41038190,Comedy
2015,71038190,30000000,4.4,41038190,Crime
2015,109712885,35000000,7.7,74712885,Drama
2015,109712885,35000000,7.7,74712885,Sport
2015,20991497,37000000,5.4,-16008503,Comedy
2015,20991497,37000000,5.4,-16008503,Drama
2015,20991497,37000000,5.4,-16008503,Romance
2015,2126511,36000000,7.2,-33873489,Action
2015,2126511,36000000,7.2,-33873489,Biography
2015,2126511,36000000,7.2,-33873489,Drama
2015,2126511,36000000,7.2,-33873489,History
2015,110008260,35000000,6.3,75008260,Comedy
2015,110008260,35000000,6.3,75008260,Romance
2015,34531832,35000000,7.1,-468168,Biography
2015,34531832,35000000,7.1,-468168,Drama
2015,34531832,35000000,7.1,-468168,Sport
2015,34507079,35000000,5.1,-492921,Action
2015,34507079,35000000,5.1,-492921,Comedy
2015,34507079,35000000,5.1,-492921,Crime
2015,10137502,35000000,7.4,-24862498,Adventure
2015,10137502,35000000,7.4,-24862498,Biography
2015,10137502,35000000,7.4,-24862498,Drama
2015,10137502,35000000,7.4,-24862498,Thriller
2015,10214013,35000000,5.4,-24785987,Comedy
2015,37432299,34000000,7.1,3432299,Drama
2015,37432299,34000000,7.1,3432299,Romance
2015,58879132,31000000,6.1,27879132,Adventure
2015,58879132,31000000,6.1,27879132,Comedy
2015,46875468,30000000,7.6,16875468,Action
2015,46875468,30000000,7.6,16875468,Crime
2015,46875468,30000000,7.6,16875468,Drama
2015,46875468,30000000,7.6,16875468,Mystery
2015,46875468,30000000,7.6,16875468,Thriller
2015,52418902,30000000,7.5,22418902,Drama
2015,52418902,30000000,7.5,22418902,Sport
2015,42478175,25000000,7.2,17478175,Drama
2015,42478175,25000000,7.2,17478175,Fantasy
2015,42478175,25000000,7.2,17478175,Romance
2015,183436380,29000000,6.5,154436380,Comedy
2015,183436380,29000000,6.5,154436380,Music
2015,161029270,28000000,7.9,133029270,Biography
2015,161029270,28000000,7.9,133029270,Crime
2015,161029270,28000000,7.9,133029270,Drama
2015,161029270,28000000,7.9,133029270,History
2015,161029270,28000000,7.9,133029270,Music
2015,70235322,28000000,7.8,42235322,Biography
2015,70235322,28000000,7.8,42235322,Comedy
2015,70235322,28000000,7.8,42235322,Drama
2015,70235322,28000000,7.8,42235322,History
2015,6998324,28000000,6.1,-21001676,Comedy
2015,6998324,28000000,6.1,-21001676,Drama
2015,12276810,26000000,6.5,-13723190,Action
2015,12276810,26000000,6.5,-13723190,Mystery
2015,12276810,26000000,6.5,-13723190,Sci-Fi
2015,12276810,26000000,6.5,-13723190,Thriller
2015,1865774,30000000,7,-28134226,Biography
2015,1865774,30000000,7,-28134226,Crime
2015,1865774,30000000,7,-28134226,Drama
2015,1865774,30000000,7,-28134226,History
2015,1865774,30000000,7,-28134226,Thriller
2015,12188642,26000000,6.9,-13811358,Biography
2015,12188642,26000000,6.9,-13811358,Drama
2015,12188642,26000000,6.9,-13811358,History
2015,28772222,105000000,5.3,-76227778,Action
2015,28772222,105000000,5.3,-76227778,Crime
2015,28772222,105000000,5.3,-76227778,Sport
2015,28772222,105000000,5.3,-76227778,Thriller
2015,5773519,40000000,6,-34226481,Drama
2015,5773519,40000000,6,-34226481,Horror
2015,5773519,40000000,6,-34226481,Sci-Fi
2015,5773519,40000000,6,-34226481,Thriller
2015,16027866,25000000,5.1,-8972134,Action
2015,16027866,25000000,5.1,-8972134,Crime
2015,16027866,25000000,5.1,-8972134,Thriller
2015,42652003,20000000,6.8,22652003,Adventure
2015,42652003,20000000,6.8,22652003,Family
2015,44988180,20000000,8.1,24988180,Biography
2015,44988180,20000000,8.1,24988180,Crime
2015,44988180,20000000,8.1,24988180,Drama
2015,44988180,20000000,8.1,24988180,History
2015,13650738,20000000,6.6,-6349262,Comedy
2015,13650738,20000000,6.6,-6349262,Drama
2015,6420319,20000000,7.4,-13579681,Drama
2015,6420319,20000000,7.4,-13579681,War
2015,2246000,20000000,7,-17754000,Biography
2015,2246000,20000000,7,-17754000,Drama
2015,2246000,20000000,7,-17754000,Sport
2015,531009,10000000,5.3,-9468991,Drama
2015,531009,10000000,5.3,-9468991,Romance
2015,26284475,17000000,5.7,9284475,Comedy
2015,17750583,30000000,7.2,-12249417,Biography
2015,17750583,30000000,7.2,-12249417,Drama
2015,44469602,17000000,7.4,27469602,Biography
2015,44469602,17000000,7.4,27469602,Drama
2015,44469602,17000000,7.4,27469602,Sport
2015,42592530,15000000,6.2,27592530,Comedy
2015,42592530,15000000,6.2,27592530,Fantasy
2015,42592530,15000000,6.2,27592530,Horror
2015,20991497,37000000,5.4,-16008503,Comedy
2015,20991497,37000000,5.4,-16008503,Drama
2015,20991497,37000000,5.4,-16008503,Romance
2015,613556,15000000,6.4,-14386444,Action
2015,613556,15000000,6.4,-14386444,Drama
2015,66009973,14800000,5.7,51209973,Comedy
2015,66009973,14800000,5.7,51209973,Drama
2015,66009973,14800000,5.7,51209973,Music
2015,12282677,14000000,5.1,-1717323,Comedy
2015,12282677,14000000,5.1,-1717323,Sci-Fi
2015,25440971,15000000,7.7,10440971,Drama
2015,25440971,15000000,7.7,10440971,Mystery
2015,25440971,15000000,7.7,10440971,Sci-Fi
2015,25440971,15000000,7.7,10440971,Thriller
2015,14677654,13000000,8.3,1677654,Drama
2015,1712111,8495000,4.5,-6782889,Horror
2015,1712111,8495000,4.5,-6782889,Thriller
2015,31990064,12000000,6.4,19990064,Drama
2015,31990064,12000000,6.4,19990064,Mystery
2015,31990064,12000000,6.4,19990064,Romance
2015,22331028,12000000,6.4,10331028,Sci-Fi
2015,22331028,12000000,6.4,10331028,Thriller
2015,177343675,135000000,6.7,42343675,Adventure
2015,177343675,135000000,6.7,42343675,Animation
2015,177343675,135000000,6.7,42343675,Comedy
2015,177343675,135000000,6.7,42343675,Family
2015,177343675,135000000,6.7,42343675,Fantasy
2015,177343675,135000000,6.7,42343675,Sci-Fi
2015,14616,12000000,7.5,-11985384,Drama
2015,38317535,11000000,7.5,27317535,Drama
2015,38317535,11000000,7.5,27317535,Romance
2015,33305037,11000000,7.3,22305037,Biography
2015,33305037,11000000,7.3,22305037,Drama
2015,33305037,11000000,7.3,22305037,History
2015,52200504,10000000,6.1,42200504,Fantasy
2015,52200504,10000000,6.1,42200504,Horror
2015,52200504,10000000,6.1,42200504,Thriller
2015,27736779,10000000,5.2,17736779,Horror
2015,27736779,10000000,5.2,17736779,Mystery
2015,27736779,10000000,5.2,17736779,Thriller
2015,33071558,10000000,6.6,23071558,Comedy
2015,33071558,10000000,6.6,23071558,Drama
2015,43771291,5000000,7.1,38771291,Mystery
2015,43771291,5000000,7.1,38771291,Thriller
2015,5348317,10000000,7.1,-4651683,Comedy
2015,5348317,10000000,7.1,-4651683,Drama
2015,5348317,10000000,7.1,-4651683,Music
2015,34017854,8500000,6.5,25517854,Comedy
2015,3442820,8000000,7.3,-4557180,Animation
2015,3442820,8000000,7.3,-4557180,Comedy
2015,3442820,8000000,7.3,-4557180,Drama
2015,3442820,8000000,7.3,-4557180,Romance
2015,17474107,7000000,7.3,10474107,Comedy
2015,17474107,7000000,7.3,10474107,Crime
2015,17474107,7000000,7.3,10474107,Drama
2015,532988,7000000,6.5,-6467012,Biography
2015,532988,7000000,6.5,-6467012,Drama
2015,532988,7000000,6.5,-6467012,Romance
2015,43771291,5000000,7.1,38771291,Mystery
2015,43771291,5000000,7.1,38771291,Thriller
2015,25799043,3300000,5.2,22499043,Horror
2015,25799043,3300000,5.2,22499043,Sci-Fi
2015,25799043,3300000,5.2,22499043,Thriller
2015,27285953,5000000,6.8,22285953,Action
2015,27285953,5000000,6.8,22285953,Thriller
2015,4700361,5000000,4.6,-299639,Drama
2015,3219029,5000000,7.1,-1780971,Crime
2015,3219029,5000000,7.1,-1780971,Horror
2015,3219029,5000000,7.1,-1780971,Music
2015,3219029,5000000,7.1,-1780971,Thriller
2015,65069140,5000000,6.2,60069140,Horror
2015,65069140,5000000,6.2,60069140,Thriller
2015,34964818,150000000,5.8,-115035182,Adventure
2015,34964818,150000000,5.8,-115035182,Family
2015,34964818,150000000,5.8,-115035182,Fantasy
2015,131175,8500000,5.6,-8368825,Drama
2015,131175,8500000,5.6,-8368825,Horror
2015,35385560,4000000,4.6,31385560,Mystery
2015,35385560,4000000,4.6,31385560,Thriller
2015,25138292,3500000,6.8,21638292,Horror
2015,25138292,3500000,6.8,21638292,Mystery
2015,29233,3500000,7,-3470767,Documentary
2015,201148159,95000000,7,106148159,Drama
2015,201148159,95000000,7,106148159,Family
2015,201148159,95000000,7,106148159,Fantasy
2015,201148159,95000000,7,106148159,Romance
2015,12985267,2300000,5.9,10685267,Drama
2015,3330,2100000,7.2,-2096670,Crime
2015,3330,2100000,7.2,-2096670,Drama
2015,3590010,2000000,6.1,1590010,Drama
2015,3590010,2000000,6.1,1590010,Music
2015,3590010,2000000,6.1,1590010,Romance
2015,2557668,2000000,5.3,557668,Crime
2015,2557668,2000000,5.3,557668,Drama
2015,2557668,2000000,5.3,557668,Thriller
2015,1477002,2000000,6.9,-522998,Drama
2015,1477002,2000000,6.9,-522998,Romance
2015,186354,13500000,4.5,-13313646,Drama
2015,444044,1900000,7.2,-1455956,Drama
2015,105943,1500000,6.1,-1394057,Comedy
2015,375723,4000000,7.9,-3624277,Comedy
2015,375723,4000000,7.9,-3624277,Drama
2015,80021740,58000000,6.4,22021740,Adventure
2015,80021740,58000000,6.4,22021740,Comedy
2015,80021740,58000000,6.4,22021740,Family
2015,80021740,58000000,6.4,22021740,Fantasy
2015,80021740,58000000,6.4,22021740,Horror
2015,62480,1000000,5.5,-937520,Drama
2015,62480,1000000,5.5,-937520,Sci-Fi
2015,177343675,135000000,6.7,42343675,Adventure
2015,177343675,135000000,6.7,42343675,Animation
2015,177343675,135000000,6.7,42343675,Comedy
2015,177343675,135000000,6.7,42343675,Family
2015,177343675,135000000,6.7,42343675,Fantasy
2015,177343675,135000000,6.7,42343675,Sci-Fi
2015,34151,450000,7.2,-415849,Documentary
2015,34151,450000,7.2,-415849,History
2015,4914,150000,7,-145086,Adventure
2015,4914,150000,7,-145086,Documentary
2015,22757819,100000,4.2,22657819,Horror
2015,22757819,100000,4.2,22657819,Thriller
2014,255108370,250000000,7.5,5108370,Adventure
2014,255108370,250000000,7.5,5108370,Fantasy
2014,245428137,210000000,5.7,35428137,Action
2014,245428137,210000000,5.7,35428137,Adventure
2014,245428137,210000000,5.7,35428137,Sci-Fi
2014,202853933,200000000,6.7,2853933,Action
2014,202853933,200000000,6.7,2853933,Adventure
2014,202853933,200000000,6.7,2853933,Fantasy
2014,202853933,200000000,6.7,2853933,Sci-Fi
2014,233914986,200000000,8,33914986,Action
2014,233914986,200000000,8,33914986,Adventure
2014,233914986,200000000,8,33914986,Fantasy
2014,233914986,200000000,8,33914986,Sci-Fi
2014,233914986,200000000,8,33914986,Thriller
2014,100189501,178000000,7.9,-77810499,Action
2014,100189501,178000000,7.9,-77810499,Adventure
2014,100189501,178000000,7.9,-77810499,Sci-Fi
2014,241407328,180000000,7,61407328,Action
2014,241407328,180000000,7,61407328,Adventure
2014,241407328,180000000,7,61407328,Family
2014,241407328,180000000,7,61407328,Fantasy
2014,241407328,180000000,7,61407328,Romance
2014,208543795,170000000,7.6,38543795,Action
2014,208543795,170000000,7.6,38543795,Adventure
2014,208543795,170000000,7.6,38543795,Drama
2014,208543795,170000000,7.6,38543795,Sci-Fi
2014,259746958,170000000,7.8,89746958,Action
2014,259746958,170000000,7.8,89746958,Adventure
2014,259746958,170000000,7.8,89746958,Sci-Fi
2014,222487711,165000000,7.9,57487711,Action
2014,222487711,165000000,7.9,57487711,Adventure
2014,222487711,165000000,7.9,57487711,Animation
2014,222487711,165000000,7.9,57487711,Comedy
2014,222487711,165000000,7.9,57487711,Drama
2014,222487711,165000000,7.9,57487711,Family
2014,222487711,165000000,7.9,57487711,Sci-Fi
2014,333130696,170000000,8.1,163130696,Action
2014,333130696,170000000,8.1,163130696,Adventure
2014,333130696,170000000,8.1,163130696,Sci-Fi
2014,187991439,165000000,8.6,22991439,Adventure
2014,187991439,165000000,8.6,22991439,Drama
2014,187991439,165000000,8.6,22991439,Sci-Fi
2014,111505642,145000000,6.9,-33494358,Adventure
2014,111505642,145000000,6.9,-33494358,Animation
2014,111505642,145000000,6.9,-33494358,Comedy
2014,111505642,145000000,6.9,-33494358,Family
2014,111505642,145000000,6.9,-33494358,Sci-Fi
2014,65007045,140000000,6.1,-74992955,Action
2014,65007045,140000000,6.1,-74992955,Adventure
2014,65007045,140000000,6.1,-74992955,Drama
2014,176997107,145000000,7.9,31997107,Action
2014,176997107,145000000,7.9,31997107,Adventure
2014,176997107,145000000,7.9,31997107,Animation
2014,176997107,145000000,7.9,31997107,Comedy
2014,176997107,145000000,7.9,31997107,Family
2014,176997107,145000000,7.9,31997107,Fantasy
2014,83348920,132000000,6.7,-48651080,Adventure
2014,83348920,132000000,6.7,-48651080,Animation
2014,83348920,132000000,6.7,-48651080,Comedy
2014,83348920,132000000,6.7,-48651080,Family
2014,101160529,125000000,5.8,-23839471,Action
2014,101160529,125000000,5.8,-23839471,Adventure
2014,101160529,125000000,5.8,-23839471,Drama
2014,113733726,127000000,6.2,-13266274,Adventure
2014,113733726,127000000,6.2,-13266274,Comedy
2014,113733726,127000000,6.2,-13266274,Family
2014,113733726,127000000,6.2,-13266274,Fantasy
2014,337103873,125000000,6.7,212103873,Adventure
2014,337103873,125000000,6.7,212103873,Sci-Fi
2014,337103873,125000000,6.7,212103873,Thriller
2014,131536019,103000000,6.4,28536019,Adventure
2014,131536019,103000000,6.4,28536019,Animation
2014,131536019,103000000,6.4,28536019,Comedy
2014,131536019,103000000,6.4,28536019,Family
2014,131536019,103000000,6.4,28536019,Musical
2014,58607007,100000000,6.2,-41392993,Action
2014,58607007,100000000,6.2,-41392993,Crime
2014,58607007,100000000,6.2,-41392993,Sci-Fi
2014,58607007,100000000,6.2,-41392993,Thriller
2014,190871240,125000000,5.9,65871240,Action
2014,190871240,125000000,5.9,65871240,Adventure
2014,190871240,125000000,5.9,65871240,Comedy
2014,190871240,125000000,5.9,65871240,Sci-Fi
2014,106369117,110000000,6.2,-3630883,Action
2014,106369117,110000000,6.2,-3630883,Drama
2014,106369117,110000000,6.2,-3630883,Fantasy
2014,106369117,110000000,6.2,-3630883,War
2014,72660029,100000000,6,-27339971,Action
2014,72660029,100000000,6,-27339971,Adventure
2014,39292022,90000000,6.1,-50707978,Action
2014,39292022,90000000,6.1,-50707978,Adventure
2014,39292022,90000000,6.1,-50707978,Thriller
2014,17176900,95000000,5.5,-77823100,Action
2014,17176900,95000000,5.5,-77823100,Adventure
2014,17176900,95000000,5.5,-77823100,Fantasy
2014,23014504,100000000,6.3,-76985496,Drama
2014,23014504,100000000,6.3,-76985496,Mystery
2014,23014504,100000000,6.3,-76985496,Romance
2014,23014504,100000000,6.3,-76985496,Sci-Fi
2014,23014504,100000000,6.3,-76985496,Thriller
2014,150832203,85000000,6.7,65832203,Adventure
2014,150832203,85000000,6.7,65832203,Mystery
2014,150832203,85000000,6.7,65832203,Sci-Fi
2014,85707116,68000000,7.6,17707116,Action
2014,85707116,68000000,7.6,17707116,Drama
2014,85707116,68000000,7.6,17707116,War
2014,23219748,80000000,5.6,-56780252,Action
2014,23219748,80000000,5.6,-56780252,Adventure
2014,23219748,80000000,5.6,-56780252,Drama
2014,23219748,80000000,5.6,-56780252,History
2014,23219748,80000000,5.6,-56780252,Romance
2014,72660029,100000000,6,-27339971,Action
2014,72660029,100000000,6,-27339971,Adventure
2014,78031620,70000000,6.1,8031620,Drama
2014,78031620,70000000,6.1,8031620,War
2014,55942830,70000000,6.3,-14057170,Action
2014,55942830,70000000,6.3,-14057170,Drama
2014,55942830,70000000,6.3,-14057170,Fantasy
2014,55942830,70000000,6.3,-14057170,Horror
2014,55942830,70000000,6.3,-14057170,War
2014,18821279,70000000,4.2,-51178721,Action
2014,18821279,70000000,4.2,-51178721,Adventure
2014,18821279,70000000,4.2,-51178721,Fantasy
2014,43568507,66000000,6.5,-22431493,Action
2014,43568507,66000000,6.5,-22431493,Crime
2014,43568507,66000000,6.5,-22431493,Drama
2014,43568507,66000000,6.5,-22431493,Thriller
2014,115603980,65000000,7.2,50603980,Biography
2014,115603980,65000000,7.2,50603980,Drama
2014,115603980,65000000,7.2,50603980,Sport
2014,115603980,65000000,7.2,50603980,War
2014,85911262,65000000,5.2,20911262,Comedy
2014,85911262,65000000,5.2,20911262,Drama
2014,85911262,65000000,5.2,20911262,Family
2014,85911262,65000000,5.2,20911262,Musical
2014,19059018,65000000,5.1,-45940982,Action
2014,19059018,65000000,5.1,-45940982,Fantasy
2014,19059018,65000000,5.1,-45940982,Sci-Fi
2014,19059018,65000000,5.1,-45940982,Thriller
2014,13750556,65000000,6.5,-51249444,Action
2014,13750556,65000000,6.5,-51249444,Crime
2014,13750556,65000000,6.5,-51249444,Thriller
2014,167735396,61000000,8.1,106735396,Crime
2014,167735396,61000000,8.1,106735396,Drama
2014,167735396,61000000,8.1,106735396,Mystery
2014,167735396,61000000,8.1,106735396,Thriller
2014,50549107,60000000,6.2,-9450893,Action
2014,50549107,60000000,6.2,-9450893,Drama
2014,50549107,60000000,6.2,-9450893,Thriller
2014,50807639,60000000,6.8,-9192361,Adventure
2014,50807639,60000000,6.8,-9192361,Animation
2014,50807639,60000000,6.8,-9192361,Comedy
2014,50807639,60000000,6.8,-9192361,Family
2014,50807639,60000000,6.8,-9192361,Fantasy
2014,257756197,60000000,7.8,197756197,Action
2014,257756197,60000000,7.8,197756197,Adventure
2014,257756197,60000000,7.8,197756197,Animation
2014,257756197,60000000,7.8,197756197,Comedy
2014,257756197,60000000,7.8,197756197,Family
2014,257756197,60000000,7.8,197756197,Fantasy
2014,22451,60000000,6.2,-59977549,Drama
2014,22451,60000000,6.2,-59977549,Fantasy
2014,22451,60000000,6.2,-59977549,Mystery
2014,22451,60000000,6.2,-59977549,Romance
2014,350123553,58800000,7.3,291323553,Action
2014,350123553,58800000,7.3,291323553,Biography
2014,350123553,58800000,7.3,291323553,Drama
2014,350123553,58800000,7.3,291323553,History
2014,350123553,58800000,7.3,291323553,Thriller
2014,350123553,58800000,7.3,291323553,War
2014,101530738,55000000,7.2,46530738,Action
2014,101530738,55000000,7.2,46530738,Crime
2014,101530738,55000000,7.2,46530738,Thriller
2014,76137505,55000000,7.2,21137505,Animation
2014,76137505,55000000,7.2,21137505,Comedy
2014,76137505,55000000,7.2,21137505,Family
2014,76137505,55000000,7.2,21137505,Fantasy
2014,51178893,50000000,6.4,1178893,Adventure
2014,51178893,50000000,6.4,1178893,Comedy
2014,51178893,50000000,6.4,1178893,Crime
2014,51178893,50000000,6.4,1178893,Family
2014,51178893,50000000,6.4,1178893,Musical
2014,191616238,50000000,7.1,141616238,Action
2014,191616238,50000000,7.1,141616238,Comedy
2014,191616238,50000000,7.1,141616238,Crime
2014,127997349,50000000,6,77997349,Adventure
2014,127997349,50000000,6,77997349,Comedy
2014,127997349,50000000,6,77997349,Drama
2014,127997349,50000000,6,77997349,Fantasy
2014,127997349,50000000,6,77997349,Musical
2014,91439400,50000000,7,41439400,Action
2014,91439400,50000000,7,41439400,Mystery
2014,91439400,50000000,7,41439400,Thriller
2014,50150619,50000000,7.3,150619,Adventure
2014,50150619,50000000,7.3,150619,Animation
2014,50150619,50000000,7.3,150619,Comedy
2014,50150619,50000000,7.3,150619,Family
2014,50150619,50000000,7.3,150619,Fantasy
2014,50150619,50000000,7.3,150619,Romance
2014,47553512,50000000,5.8,-2446488,Action
2014,47553512,50000000,5.8,-2446488,Thriller
2014,47105085,50000000,7.4,-2894915,Crime
2014,47105085,50000000,7.4,-2894915,Drama
2014,89253340,48000000,6,41253340,Action
2014,89253340,48000000,6,41253340,Thriller
2014,46280507,40000000,6.5,6280507,Comedy
2014,46280507,40000000,6.5,6280507,Romance
2014,6105175,44000000,6.6,-37894825,Comedy
2014,126546825,40000000,6.4,86546825,Action
2014,126546825,40000000,6.4,86546825,Sci-Fi
2014,126546825,40000000,6.4,86546825,Thriller
2014,86208010,35000000,5.7,51208010,Comedy
2014,115603980,65000000,7.2,50603980,Biography
2014,115603980,65000000,7.2,50603980,Drama
2014,115603980,65000000,7.2,50603980,Sport
2014,115603980,65000000,7.2,50603980,War
2014,83906114,40000000,6,43906114,Comedy
2014,83906114,40000000,6,43906114,Romance
2014,54414716,42000000,6.3,12414716,Comedy
2014,54414716,42000000,6.3,12414716,Crime
2014,47034272,40000000,6.9,7034272,Biography
2014,47034272,40000000,6.9,7034272,Drama
2014,47034272,40000000,6.9,7034272,Music
2014,47034272,40000000,6.9,7034272,Musical
2014,38543473,40000000,5.1,-1456527,Comedy
2014,42615685,40000000,6.1,2615685,Comedy
2014,42615685,40000000,6.1,2615685,Western
2014,42019483,36000000,6.4,6019483,Drama
2014,42019483,36000000,6.4,6019483,Family
2014,10499968,35000000,5.7,-24500032,Action
2014,10499968,35000000,5.7,-24500032,Crime
2014,10499968,35000000,5.7,-24500032,Drama
2014,10499968,35000000,5.7,-24500032,Thriller
2014,102413606,34000000,6.8,68413606,Action
2014,102413606,34000000,6.8,68413606,Mystery
2014,102413606,34000000,6.8,68413606,Sci-Fi
2014,102413606,34000000,6.8,68413606,Thriller
2014,59073773,25000000,8.1,34073773,Adventure
2014,59073773,25000000,8.1,34073773,Comedy
2014,59073773,25000000,8.1,34073773,Crime
2014,59073773,25000000,8.1,34073773,Drama
2014,64238770,42000000,5.8,22238770,Adventure
2014,64238770,42000000,5.8,22238770,Animation
2014,64238770,42000000,5.8,22238770,Comedy
2014,64238770,42000000,5.8,22238770,Family
2014,30513940,30000000,6.9,513940,Biography
2014,30513940,30000000,6.9,513940,Drama
2014,30513940,30000000,6.9,513940,Music
2014,30523568,30000000,6.2,523568,Horror
2014,30523568,30000000,6.2,523568,Mystery
2014,30523568,30000000,6.2,523568,Thriller
2014,66950483,28000000,6.2,38950483,Comedy
2014,66950483,28000000,6.2,38950483,Family
2014,30688364,28000000,6.2,2688364,Action
2014,30688364,28000000,6.2,2688364,Drama
2014,30688364,28000000,6.2,2688364,Thriller
2014,20285518,28000000,5.7,-7714482,Action
2014,20285518,28000000,5.7,-7714482,Crime
2014,20285518,28000000,5.7,-7714482,Drama
2014,20285518,28000000,5.7,-7714482,Thriller
2014,25977365,28000000,6.5,-2022635,Crime
2014,25977365,28000000,6.5,-2022635,Drama
2014,25977365,28000000,6.5,-2022635,Mystery
2014,25977365,28000000,6.5,-2022635,Thriller
2014,26761283,26000000,6.7,761283,Drama
2014,26761283,26000000,6.7,761283,Romance
2014,134141530,25000000,6.2,109141530,Action
2014,134141530,25000000,6.2,109141530,Comedy
2014,134141530,25000000,6.2,109141530,Crime
2014,134141530,25000000,6.2,109141530,Romance
2014,36447959,25000000,7,11447959,Biography
2014,36447959,25000000,7,11447959,Drama
2014,36447959,25000000,7,11447959,Sport
2014,45089048,25000000,6.5,20089048,Drama
2014,45089048,25000000,6.5,20089048,Romance
2014,45089048,25000000,6.5,20089048,Sci-Fi
2014,33631221,25000000,6,8631221,Crime
2014,33631221,25000000,6,8631221,Drama
2014,33631221,25000000,6,8631221,Thriller
2014,28831145,25000000,6.8,3831145,Drama
2014,28831145,25000000,6.8,3831145,Sport
2014,129115,25000000,6.5,-24870885,Action
2014,129115,25000000,6.5,-24870885,Drama
2014,65182182,24000000,5.7,41182182,Comedy
2014,65182182,24000000,5.7,41182182,Romance
2014,4190530,22500000,7.1,-18309470,Drama
2014,4190530,22500000,7.1,-18309470,War
2014,54235441,22000000,7.3,32235441,Comedy
2014,54235441,22000000,7.3,32235441,Drama
2014,59696176,22000000,5.6,37696176,Biography
2014,59696176,22000000,5.6,37696176,Drama
2014,59696176,22000000,5.6,37696176,History
2014,2963012,22000000,6.3,-19036988,Drama
2014,2963012,22000000,6.3,-19036988,Mystery
2014,2963012,22000000,6.3,-19036988,Thriller
2014,84518155,20000000,4.9,64518155,Comedy
2014,52066000,20000000,7.5,32066000,Biography
2014,52066000,20000000,7.5,32066000,Drama
2014,52066000,20000000,7.5,32066000,History
2014,34290142,19800000,6.6,14490142,Comedy
2014,34290142,19800000,6.6,14490142,Drama
2014,23393765,20000000,6.3,3393765,Drama
2014,23393765,20000000,6.3,3393765,Romance
2014,8093318,20000000,6.7,-11906682,Comedy
2014,8093318,20000000,6.7,-11906682,Crime
2014,8093318,20000000,6.7,-11906682,Drama
2014,8093318,20000000,6.7,-11906682,Mystery
2014,8093318,20000000,6.7,-11906682,Romance
2014,5749134,20000000,7,-14250866,Action
2014,5749134,20000000,7,-14250866,Crime
2014,5749134,20000000,7,-14250866,Drama
2014,5749134,20000000,7,-14250866,Thriller
2014,150056505,18000000,6.4,132056505,Comedy
2014,13998282,16000000,3.1,-2001718,Action
2014,13998282,16000000,3.1,-2001718,Drama
2014,13998282,16000000,3.1,-2001718,Fantasy
2014,13998282,16000000,3.1,-2001718,Mystery
2014,13998282,16000000,3.1,-2001718,Thriller
2014,42335698,18000000,7.8,24335698,Comedy
2014,42335698,18000000,7.8,24335698,Drama
2014,42335698,18000000,7.8,24335698,Romance
2014,15155772,18000000,5.7,-2844228,Comedy
2014,15155772,18000000,5.7,-2844228,Drama
2014,15155772,18000000,5.7,-2844228,Romance
2014,82389560,17000000,6.5,65389560,Comedy
2014,106869,17000000,6.6,-16893131,Crime
2014,106869,17000000,6.6,-16893131,Drama
2014,106869,17000000,6.6,-16893131,Romance
2014,106869,17000000,6.6,-16893131,Thriller
2014,13998282,16000000,3.1,-2001718,Action
2014,13998282,16000000,3.1,-2001718,Drama
2014,13998282,16000000,3.1,-2001718,Fantasy
2014,13998282,16000000,3.1,-2001718,Mystery
2014,13998282,16000000,3.1,-2001718,Thriller
2014,2428883,16000000,6.6,-13571117,Drama
2014,2428883,16000000,6.6,-13571117,Western
2014,91121452,14000000,8.1,77121452,Biography
2014,91121452,14000000,8.1,77121452,Drama
2014,91121452,14000000,8.1,77121452,Thriller
2014,91121452,14000000,8.1,77121452,War
2014,35887263,15000000,7.7,20887263,Biography
2014,35887263,15000000,7.7,20887263,Drama
2014,35887263,15000000,7.7,20887263,Romance
2014,37877959,15000000,7.1,22877959,Adventure
2014,37877959,15000000,7.1,22877959,Biography
2014,37877959,15000000,7.1,22877959,Drama
2014,30127963,15000000,6.7,15127963,Drama
2014,30127963,15000000,6.7,15127963,Family
2014,30127963,15000000,6.7,15127963,Sport
2014,24984868,15000000,6.3,9984868,Action
2014,24984868,15000000,6.3,9984868,Crime
2014,24984868,15000000,6.3,9984868,Thriller
2014,17237244,15000000,6.8,2237244,Crime
2014,17237244,15000000,6.8,2237244,Drama
2014,17237244,15000000,6.8,2237244,Thriller
2014,3958500,8200000,6.8,-4241500,Biography
2014,3958500,8200000,6.8,-4241500,Drama
2014,3958500,8200000,6.8,-4241500,History
2014,190871240,125000000,5.9,65871240,Action
2014,190871240,125000000,5.9,65871240,Adventure
2014,190871240,125000000,5.9,65871240,Comedy
2014,190871240,125000000,5.9,65871240,Sci-Fi
2014,58607007,100000000,6.2,-41392993,Action
2014,58607007,100000000,6.2,-41392993,Crime
2014,58607007,100000000,6.2,-41392993,Sci-Fi
2014,58607007,100000000,6.2,-41392993,Thriller
2014,44134898,13000000,7.3,31134898,Comedy
2014,44134898,13000000,7.3,31134898,Drama
2014,48637684,12500000,6.1,36137684,Comedy
2014,48637684,12500000,6.1,36137684,Romance
2014,52543632,13200000,5.6,39343632,Crime
2014,52543632,13200000,5.6,39343632,Thriller
2014,38916903,13000000,5.8,25916903,Adventure
2014,38916903,13000000,5.8,25916903,Family
2014,38916903,13000000,5.8,25916903,Sci-Fi
2014,124868837,12000000,7.8,112868837,Drama
2014,124868837,12000000,7.8,112868837,Romance
2014,25277561,12000000,6.5,13277561,Comedy
2014,25277561,12000000,6.5,13277561,Romance
2014,91443253,12000000,5.8,79443253,Biography
2014,91443253,12000000,5.8,79443253,Drama
2014,50461335,11000000,6.8,39461335,Drama
2014,50461335,11000000,6.8,39461335,Fantasy
2014,50461335,11000000,6.8,39461335,Music
2014,50461335,11000000,6.8,39461335,Romance
2014,14479776,10000000,7,4479776,Biography
2014,14479776,10000000,7,4479776,Crime
2014,14479776,10000000,7,4479776,Drama
2014,14479776,10000000,7,4479776,Romance
2014,21569041,9000000,6.6,12569041,Drama
2014,7574066,10000000,6.3,-2425934,Comedy
2014,7574066,10000000,6.3,-2425934,Drama
2014,3093491,5000000,6.6,-1906509,Biography
2014,3093491,5000000,6.6,-1906509,Drama
2014,71519230,9000000,6.5,62519230,Action
2014,71519230,9000000,6.5,62519230,Horror
2014,71519230,9000000,6.5,62519230,Sci-Fi
2014,71519230,9000000,6.5,62519230,Thriller
2014,162,9000000,5.7,-8999838,Action
2014,162,9000000,5.7,-8999838,Crime
2014,162,9000000,5.7,-8999838,Thriller
2014,32279955,8500000,7.9,23779955,Crime
2014,32279955,8500000,7.9,23779955,Drama
2014,32279955,8500000,7.9,23779955,Thriller
2014,26049082,8000000,6.1,18049082,Comedy
2014,26049082,8000000,6.1,18049082,Romance
2014,52961,8000000,5.3,-7947039,Drama
2014,15818967,7000000,4,8818967,Horror
2014,15818967,7000000,4,8818967,Mystery
2014,14612840,7000000,6.9,7612840,Drama
2014,14612840,7000000,6.9,7612840,Music
2014,84263837,6500000,5.4,77763837,Horror
2014,84263837,6500000,5.4,77763837,Mystery
2014,3588432,6000000,6.7,-2411568,Comedy
2014,3588432,6000000,6.7,-2411568,Drama
2014,20200,6000000,5.8,-5979800,Drama
2014,20200,6000000,5.8,-5979800,Music
2014,50820940,5000000,4.4,45820940,Fantasy
2014,50820940,5000000,4.4,45820940,Horror
2014,32453345,5000000,5,27453345,Fantasy
2014,32453345,5000000,5,27453345,Horror
2014,32453345,5000000,5,27453345,Thriller
2014,21197315,5000000,6.1,16197315,Horror
2014,21197315,5000000,6.1,16197315,Mystery
2014,21197315,5000000,6.1,16197315,Thriller
2014,17382982,5000000,5.2,12382982,Drama
2014,17382982,5000000,5.2,12382982,Thriller
2014,18656400,5000000,7.5,13656400,Drama
2014,2445646,5000000,7,-2554354,Biography
2014,2445646,5000000,7,-2554354,Crime
2014,2445646,5000000,7,-2554354,Drama
2014,2445646,5000000,7,-2554354,Mystery
2014,2445646,5000000,7,-2554354,Thriller
2014,830210,5000000,4.4,-4169790,Drama
2014,830210,5000000,4.4,-4169790,Mystery
2014,830210,5000000,4.4,-4169790,Sci-Fi
2014,37440,5000000,7.5,-4962560,Comedy
2014,37440,5000000,7.5,-4962560,Drama
2014,37440,5000000,7.5,-4962560,Music
2014,10429707,5000000,5.4,5429707,Comedy
2014,8691,4500000,5.8,-4491309,Action
2014,8691,4500000,5.8,-4491309,Adventure
2014,65007045,140000000,6.1,-74992955,Action
2014,65007045,140000000,6.1,-74992955,Adventure
2014,65007045,140000000,6.1,-74992955,Drama
2014,25359200,4000000,8,21359200,Drama
2014,17314483,4000000,4.7,13314483,Comedy
2014,17314483,4000000,4.7,13314483,Fantasy
2014,20262,4000000,6.1,-3979738,Drama
2014,143653,4000000,6,-3856347,Biography
2014,143653,4000000,6,-3856347,Drama
2014,13092000,3300000,8.5,9792000,Drama
2014,13092000,3300000,8.5,9792000,Music
2014,1821983,3000000,5.4,-1178017,Comedy
2014,1821983,3000000,5.4,-1178017,Drama
2014,1821983,3000000,5.4,-1178017,Horror
2014,33631221,25000000,6,8631221,Crime
2014,33631221,25000000,6,8631221,Drama
2014,33631221,25000000,6,8631221,Thriller
2014,14673301,2000000,6.9,12673301,Horror
2014,14673301,2000000,6.9,12673301,Mystery
2014,31537320,1000000,5.7,30537320,Horror
2014,31537320,1000000,5.7,30537320,Mystery
2014,31537320,1000000,5.7,30537320,Thriller
2014,100240,1000000,6.8,-899760,Documentary
2014,35688,600000,5.1,-564312,Comedy
2014,21199,500000,6.8,-478801,Action
2014,21199,500000,6.8,-478801,Biography
2014,21199,500000,6.8,-478801,Documentary
2014,21199,500000,6.8,-478801,Sport
2014,2468,300000,4.8,-297532,Thriller
2014,5858,150000,7.1,-144142,Documentary
2014,30084,70000,5.6,-39916,Comedy
2014,30084,70000,5.6,-39916,Drama
2014,10499968,35000000,5.7,-24500032,Action
2014,10499968,35000000,5.7,-24500032,Crime
2014,10499968,35000000,5.7,-24500032,Drama
2014,10499968,35000000,5.7,-24500032,Thriller
2013,89289910,215000000,6.5,-125710090,Action
2013,89289910,215000000,6.5,-125710090,Adventure
2013,89289910,215000000,6.5,-125710090,Western
2013,291021565,225000000,7.2,66021565,Action
2013,291021565,225000000,7.2,66021565,Adventure
2013,291021565,225000000,7.2,66021565,Fantasy
2013,291021565,225000000,7.2,66021565,Sci-Fi
2013,258355354,225000000,7.9,33355354,Adventure
2013,258355354,225000000,7.9,33355354,Fantasy
2013,408992272,200000000,7.2,208992272,Action
2013,408992272,200000000,7.2,208992272,Adventure
2013,408992272,200000000,7.2,208992272,Sci-Fi
2013,268488329,200000000,7.3,68488329,Adventure
2013,268488329,200000000,7.3,68488329,Animation
2013,268488329,200000000,7.3,68488329,Comedy
2013,268488329,200000000,7.3,68488329,Family
2013,268488329,200000000,7.3,68488329,Fantasy
2013,234903076,215000000,6.4,19903076,Adventure
2013,234903076,215000000,6.4,19903076,Family
2013,234903076,215000000,6.4,19903076,Fantasy
2013,202351611,190000000,7,12351611,Action
2013,202351611,190000000,7,12351611,Adventure
2013,202351611,190000000,7,12351611,Horror
2013,202351611,190000000,7,12351611,Sci-Fi
2013,202351611,190000000,7,12351611,Thriller
2013,228756232,190000000,7.8,38756232,Action
2013,228756232,190000000,7.8,38756232,Adventure
2013,228756232,190000000,7.8,38756232,Sci-Fi
2013,65171860,195000000,6.3,-129828140,Adventure
2013,65171860,195000000,6.3,-129828140,Fantasy
2013,144812796,105000000,7.3,39812796,Drama
2013,144812796,105000000,7.3,39812796,Romance
2013,101785482,190000000,7,-88214518,Action
2013,101785482,190000000,7,-88214518,Adventure
2013,101785482,190000000,7,-88214518,Sci-Fi
2013,38297305,175000000,6.3,-136702695,Action
2013,38297305,175000000,6.3,-136702695,Adventure
2013,38297305,175000000,6.3,-136702695,Drama
2013,38297305,175000000,6.3,-136702695,Fantasy
2013,400736600,150000000,7.6,250736600,Adventure
2013,400736600,150000000,7.6,250736600,Animation
2013,400736600,150000000,7.6,250736600,Comedy
2013,400736600,150000000,7.6,250736600,Family
2013,400736600,150000000,7.6,250736600,Fantasy
2013,400736600,150000000,7.6,250736600,Musical
2013,206360018,170000000,7.1,36360018,Action
2013,206360018,170000000,7.1,36360018,Adventure
2013,206360018,170000000,7.1,36360018,Fantasy
2013,73103784,150000000,6.4,-76896216,Action
2013,73103784,150000000,6.4,-76896216,Drama
2013,73103784,150000000,6.4,-76896216,Thriller
2013,122512052,130000000,5.8,-7487948,Action
2013,122512052,130000000,5.8,-7487948,Adventure
2013,122512052,130000000,5.8,-7487948,Sci-Fi
2013,122512052,130000000,5.8,-7487948,Thriller
2013,83024900,135000000,6.5,-51975100,Adventure
2013,83024900,135000000,6.5,-51975100,Animation
2013,83024900,135000000,6.5,-51975100,Comedy
2013,83024900,135000000,6.5,-51975100,Family
2013,83024900,135000000,6.5,-51975100,Sport
2013,424645577,130000000,7.6,294645577,Adventure
2013,424645577,130000000,7.6,294645577,Sci-Fi
2013,424645577,130000000,7.6,294645577,Thriller
2013,60522097,130000000,4.9,-69477903,Action
2013,60522097,130000000,4.9,-69477903,Adventure
2013,60522097,130000000,4.9,-69477903,Sci-Fi
2013,33592415,130000000,5.6,-96407585,Action
2013,33592415,130000000,5.6,-96407585,Comedy
2013,33592415,130000000,5.6,-96407585,Fantasy
2013,93050117,115000000,6.6,-21949883,Action
2013,93050117,115000000,6.6,-21949883,Drama
2013,93050117,115000000,6.6,-21949883,Sci-Fi
2013,93050117,115000000,6.6,-21949883,Thriller
2013,89021735,120000000,7,-30978265,Action
2013,89021735,120000000,7,-30978265,Adventure
2013,89021735,120000000,7,-30978265,Mystery
2013,89021735,120000000,7,-30978265,Sci-Fi
2013,132550960,120000000,6.7,12550960,Action
2013,132550960,120000000,6.7,12550960,Adventure
2013,132550960,120000000,6.7,12550960,Sci-Fi
2013,132550960,120000000,6.7,12550960,Thriller
2013,187165546,135000000,7.3,52165546,Adventure
2013,187165546,135000000,7.3,52165546,Animation
2013,187165546,135000000,7.3,52165546,Comedy
2013,187165546,135000000,7.3,52165546,Family
2013,187165546,135000000,7.3,52165546,Fantasy
2013,274084951,100000000,7.8,174084951,Adventure
2013,274084951,100000000,7.8,174084951,Drama
2013,274084951,100000000,7.8,174084951,Sci-Fi
2013,274084951,100000000,7.8,174084951,Thriller
2013,71017784,105000000,5.4,-33982216,Adventure
2013,71017784,105000000,5.4,-33982216,Animation
2013,71017784,105000000,5.4,-33982216,Comedy
2013,71017784,105000000,5.4,-33982216,Family
2013,71017784,105000000,5.4,-33982216,Fantasy
2013,61656849,110000000,6.7,-48343151,Action
2013,61656849,110000000,6.7,-48343151,Sci-Fi
2013,107515297,100000000,6.7,7515297,Adventure
2013,107515297,100000000,6.7,7515297,Animation
2013,107515297,100000000,6.7,7515297,Family
2013,107515297,100000000,6.7,7515297,Fantasy
2013,116866727,100000000,8.2,16866727,Biography
2013,116866727,100000000,8.2,16866727,Comedy
2013,116866727,100000000,8.2,16866727,Crime
2013,116866727,100000000,8.2,16866727,Drama
2013,67344392,92000000,5.3,-24655608,Action
2013,67344392,92000000,5.3,-24655608,Thriller
2013,58229120,90000000,7.3,-31770880,Adventure
2013,58229120,90000000,7.3,-31770880,Comedy
2013,58229120,90000000,7.3,-31770880,Drama
2013,58229120,90000000,7.3,-31770880,Fantasy
2013,58229120,90000000,7.3,-31770880,Romance
2013,68558662,90000000,5.9,-21441338,Adventure
2013,68558662,90000000,5.9,-21441338,Family
2013,68558662,90000000,5.9,-21441338,Fantasy
2013,53215979,84000000,6.7,-30784021,Action
2013,53215979,84000000,6.7,-30784021,Comedy
2013,53215979,84000000,6.7,-30784021,Crime
2013,53215979,84000000,6.7,-30784021,Thriller
2013,133668525,80000000,5.4,53668525,Comedy
2013,36073232,80000000,5.2,-43926768,Adventure
2013,36073232,80000000,5.2,-43926768,Animation
2013,36073232,80000000,5.2,-43926768,Family
2013,119793567,78000000,6.5,41793567,Animation
2013,119793567,78000000,6.5,41793567,Comedy
2013,119793567,78000000,6.5,41793567,Family
2013,119793567,78000000,6.5,41793567,Fantasy
2013,119793567,78000000,6.5,41793567,Sci-Fi
2013,368049635,76000000,7.5,292049635,Animation
2013,368049635,76000000,7.5,292049635,Comedy
2013,368049635,76000000,7.5,292049635,Family
2013,368049635,76000000,7.5,292049635,Sci-Fi
2013,117698894,75000000,7.3,42698894,Crime
2013,117698894,75000000,7.3,42698894,Mystery
2013,117698894,75000000,7.3,42698894,Thriller
2013,98895417,70000000,6.5,28895417,Action
2013,98895417,70000000,6.5,28895417,Thriller
2013,8460990,70000000,5.6,-61539010,Adventure
2013,8460990,70000000,5.6,-61539010,Animation
2013,8460990,70000000,5.6,-61539010,Family
2013,8460990,70000000,5.6,-61539010,Fantasy
2013,8460990,70000000,5.6,-61539010,Musical
2013,25121291,50000000,6.7,-24878709,Action
2013,25121291,50000000,6.7,-24878709,Crime
2013,25121291,50000000,6.7,-24878709,Mystery
2013,25121291,50000000,6.7,-24878709,Sci-Fi
2013,25121291,50000000,6.7,-24878709,Thriller
2013,75573300,61000000,6.7,14573300,Action
2013,75573300,61000000,6.7,14573300,Comedy
2013,75573300,61000000,6.7,14573300,Crime
2013,75573300,61000000,6.7,14573300,Drama
2013,75573300,61000000,6.7,14573300,Thriller
2013,45996718,60000000,6.7,-14003282,Action
2013,45996718,60000000,6.7,-14003282,Crime
2013,45996718,60000000,6.7,-14003282,Drama
2013,45996718,60000000,6.7,-14003282,Thriller
2013,31165421,60000000,6,-28834579,Fantasy
2013,31165421,60000000,6,-28834579,Horror
2013,31165421,60000000,6,-28834579,Mystery
2013,31165421,60000000,6,-28834579,Romance
2013,44665963,58000000,6.3,-13334037,Comedy
2013,107100855,55000000,7.9,52100855,Biography
2013,107100855,55000000,7.9,52100855,Drama
2013,107100855,55000000,7.9,52100855,Thriller
2013,55747724,55000000,5.9,747724,Adventure
2013,55747724,55000000,5.9,747724,Animation
2013,55747724,55000000,5.9,747724,Comedy
2013,55747724,55000000,5.9,747724,Family
2013,2175312,50000000,6.3,-47824688,Comedy
2013,55682070,50000000,6.1,5682070,Action
2013,55682070,50000000,6.1,5682070,Fantasy
2013,55682070,50000000,6.1,5682070,Horror
2013,26616999,40000000,5.9,-13383001,Action
2013,26616999,40000000,5.9,-13383001,Adventure
2013,26616999,40000000,5.9,-13383001,Romance
2013,26616999,40000000,5.9,-13383001,Sci-Fi
2013,26616999,40000000,5.9,-13383001,Thriller
2013,19445217,60000000,6.2,-40554783,Drama
2013,19445217,60000000,6.2,-40554783,Fantasy
2013,19445217,60000000,6.2,-40554783,Romance
2013,60962878,46000000,8.1,14962878,Crime
2013,60962878,46000000,8.1,14962878,Drama
2013,60962878,46000000,8.1,14962878,Mystery
2013,60962878,46000000,8.1,14962878,Thriller
2013,159578352,43000000,6.6,116578352,Action
2013,159578352,43000000,6.6,116578352,Comedy
2013,159578352,43000000,6.6,116578352,Crime
2013,150117807,40000000,7.3,110117807,Crime
2013,150117807,40000000,7.3,110117807,Drama
2013,125069696,40000000,7.6,85069696,Action
2013,125069696,40000000,7.6,85069696,Biography
2013,125069696,40000000,7.6,85069696,Drama
2013,125069696,40000000,7.6,85069696,Thriller
2013,125069696,40000000,7.6,85069696,War
2013,95001343,40000000,7.5,55001343,Biography
2013,95001343,40000000,7.5,55001343,Drama
2013,95001343,40000000,7.5,55001343,Sport
2013,57011847,40000000,5.9,17011847,Adventure
2013,57011847,40000000,5.9,17011847,Animation
2013,57011847,40000000,5.9,17011847,Comedy
2013,57011847,40000000,5.9,17011847,Family
2013,57011847,40000000,5.9,17011847,Sci-Fi
2013,4563029,39200000,7,-34636971,Action
2013,4563029,39200000,7,-34636971,Drama
2013,4563029,39200000,7,-34636971,Sci-Fi
2013,4563029,39200000,7,-34636971,Thriller
2013,29802761,40000000,6.4,-10197239,Comedy
2013,29802761,40000000,6.4,-10197239,Sport
2013,6594136,38600000,6.5,-32005864,Action
2013,6594136,38600000,6.5,-32005864,Biography
2013,6594136,38600000,6.5,-32005864,Drama
2013,41997790,38000000,6.4,3997790,Action
2013,41997790,38000000,6.4,3997790,Sci-Fi
2013,41997790,38000000,6.4,3997790,Thriller
2013,26903709,38000000,8.1,-11096291,Action
2013,26903709,38000000,8.1,-11096291,Biography
2013,26903709,38000000,8.1,-11096291,Drama
2013,26903709,38000000,8.1,-11096291,Sport
2013,150368971,37000000,7,113368971,Comedy
2013,150368971,37000000,7,113368971,Crime
2013,134455175,35000000,5.7,99455175,Comedy
2013,134455175,35000000,5.7,99455175,Crime
2013,83299761,35000000,7.5,48299761,Biography
2013,83299761,35000000,7.5,48299761,Comedy
2013,83299761,35000000,7.5,48299761,Drama
2013,83299761,35000000,7.5,48299761,History
2013,83299761,35000000,7.5,48299761,Music
2013,19692608,35000000,6.2,-15307392,Crime
2013,19692608,35000000,6.2,-15307392,Drama
2013,19692608,35000000,6.2,-15307392,Thriller
2013,17609982,35000000,6.2,-17390018,Action
2013,17609982,35000000,6.2,-17390018,Crime
2013,17609982,35000000,6.2,-17390018,Romance
2013,17609982,35000000,6.2,-17390018,Thriller
2013,8324748,35000000,7.1,-26675252,Biography
2013,8324748,35000000,7.1,-26675252,Drama
2013,8324748,35000000,7.1,-26675252,History
2013,4091,34000000,6.3,-33995909,Adventure
2013,4091,34000000,6.3,-33995909,Animation
2013,4091,34000000,6.3,-33995909,Comedy
2013,4091,34000000,6.3,-33995909,Family
2013,4091,34000000,6.3,-33995909,Fantasy
2013,101470202,32000000,6.7,69470202,Comedy
2013,101470202,32000000,6.7,69470202,Fantasy
2013,21784432,35000000,5.6,-13215568,Comedy
2013,99462,33000000,7.1,-32900538,Action
2013,99462,33000000,7.1,-32900538,Adventure
2013,99462,33000000,7.1,-32900538,Drama
2013,99462,33000000,7.1,-32900538,Family
2013,22525921,30000000,5.9,-7474079,Comedy
2013,116631310,30000000,7.2,86631310,Biography
2013,116631310,30000000,7.2,86631310,Drama
2013,66359959,35000000,6.9,31359959,Comedy
2013,66359959,35000000,6.9,31359959,Horror
2013,66359959,35000000,6.9,31359959,Romance
2013,35266619,30000000,5.9,5266619,Drama
2013,35266619,30000000,5.9,5266619,Fantasy
2013,35266619,30000000,5.9,5266619,Horror
2013,32154410,30000000,7.1,2154410,Crime
2013,32154410,30000000,7.1,2154410,Drama
2013,32154410,30000000,7.1,2154410,Thriller
2013,12026670,45000000,6.4,-32973330,Action
2013,12026670,45000000,6.4,-32973330,Crime
2013,12026670,45000000,6.4,-32973330,Thriller
2013,19316646,30000000,5.6,-10683354,Crime
2013,19316646,30000000,5.6,-10683354,Thriller
2013,10880926,30000000,6.5,-19119074,Action
2013,10880926,30000000,6.5,-19119074,Crime
2013,10880926,30000000,6.5,-19119074,Drama
2013,10880926,30000000,6.5,-19119074,Thriller
2013,63910583,28000000,6.6,35910583,Comedy
2013,63910583,28000000,6.6,35910583,Romance
2013,71346930,28000000,6.7,43346930,Drama
2013,71346930,28000000,6.7,43346930,Romance
2013,71346930,28000000,6.7,43346930,Thriller
2013,28751715,28000000,6.6,751715,Action
2013,28751715,28000000,6.6,751715,Comedy
2013,28751715,28000000,6.6,751715,Crime
2013,49874933,26000000,6.5,23874933,Comedy
2013,49874933,26000000,6.5,23874933,Crime
2013,49874933,26000000,6.5,23874933,Drama
2013,3254172,28000000,6.2,-24745828,Biography
2013,3254172,28000000,6.2,-24745828,Drama
2013,3254172,28000000,6.2,-24745828,Thriller
2013,52528330,25000000,4.7,27528330,Comedy
2013,52528330,25000000,4.7,27528330,Drama
2013,41229,25500000,6.5,-25458771,Crime
2013,41229,25500000,6.5,-25458771,Drama
2013,41229,25500000,6.5,-25458771,Thriller
2013,37738400,25000000,7.3,12738400,Drama
2013,85433,13500000,7.8,-13414567,Crime
2013,85433,13500000,7.8,-13414567,Drama
2013,85433,13500000,7.8,-13414567,Mystery
2013,85433,13500000,7.8,-13414567,Romance
2013,16969390,25000000,5.3,-8030610,Crime
2013,16969390,25000000,5.3,-8030610,Drama
2013,16969390,25000000,5.3,-8030610,Thriller
2013,25556065,23000000,8,2556065,Drama
2013,25556065,23000000,8,2556065,Romance
2013,25556065,23000000,8,2556065,Sci-Fi
2013,4756,25000000,5.4,-24995244,Adventure
2013,4756,25000000,5.4,-24995244,Family
2013,4756,25000000,5.4,-24995244,Fantasy
2013,30659817,26000000,6.4,4659817,Comedy
2013,30659817,26000000,6.4,4659817,Drama
2013,19783777,22000000,6.5,-2216223,Action
2013,19783777,22000000,6.5,-2216223,Crime
2013,19783777,22000000,6.5,-2216223,Drama
2013,19783777,22000000,6.5,-2216223,Thriller
2013,11326836,22000000,6.8,-10673164,Crime
2013,11326836,22000000,6.8,-10673164,Drama
2013,11326836,22000000,6.8,-10673164,Thriller
2013,137387272,20000000,7.5,117387272,Horror
2013,137387272,20000000,7.5,117387272,Mystery
2013,137387272,20000000,7.5,117387272,Thriller
2013,56667870,20000000,8.1,36667870,Biography
2013,56667870,20000000,8.1,36667870,Drama
2013,56667870,20000000,8.1,36667870,History
2013,34334256,11000000,4.8,23334256,Horror
2013,34334256,11000000,4.8,23334256,Thriller
2013,32014289,20000000,3.5,12014289,Comedy
2013,26003149,20000000,7,6003149,Action
2013,26003149,20000000,7,6003149,Comedy
2013,26003149,20000000,7,6003149,Sci-Fi
2013,8888355,20000000,5,-11111645,Drama
2013,8888355,20000000,5,-11111645,Music
2013,7268659,20000000,5.6,-12731341,Action
2013,7268659,20000000,5.6,-12731341,Comedy
2013,7268659,20000000,5.6,-12731341,Crime
2013,7268659,20000000,5.6,-12731341,Thriller
2013,21483154,19000000,7.6,2483154,Drama
2013,21483154,19000000,7.6,2483154,War
2013,33404871,18000000,7.3,15404871,Drama
2013,10494494,18000000,4.4,-7505506,Action
2013,10494494,18000000,4.4,-7505506,Crime
2013,10494494,18000000,4.4,-7505506,Thriller
2013,13362308,18000000,6.9,-4637692,Drama
2013,4435083,18000000,7.1,-13564917,Biography
2013,4435083,18000000,7.1,-13564917,Drama
2013,4435083,18000000,7.1,-13564917,Romance
2013,4435083,18000000,7.1,-13564917,War
2013,7017178,17500000,4.4,-10482822,Drama
2013,7017178,17500000,4.4,-10482822,Family
2013,7017178,17500000,4.4,-10482822,Music
2013,7017178,17500000,4.4,-10482822,Musical
2013,70492685,17000000,6.7,53492685,Comedy
2013,70492685,17000000,6.7,53492685,Drama
2013,54239856,17000000,6.5,37239856,Horror
2013,1984743,16000000,6.6,-14015257,Drama
2013,1984743,16000000,6.6,-14015257,Romance
2013,2319187,20000000,7,-17680813,Crime
2013,2319187,20000000,7,-17680813,Drama
2013,2319187,20000000,7,-17680813,Mystery
2013,2319187,20000000,7,-17680813,Thriller
2013,71588220,20000000,6.2,51588220,Fantasy
2013,71588220,20000000,6.2,51588220,Horror
2013,101978840,15000000,6.6,86978840,Comedy
2013,42919096,15000000,6.5,27919096,Action
2013,42919096,15000000,6.5,27919096,Drama
2013,42919096,15000000,6.5,27919096,Thriller
2013,9123834,15000000,5.3,-5876166,Comedy
2013,9123834,15000000,5.3,-5876166,Romance
2013,25675765,13000000,5.9,12675765,Comedy
2013,18004225,13000000,5.7,5004225,Comedy
2013,18004225,13000000,5.7,5004225,Drama
2013,18004225,13000000,5.7,5004225,Romance
2013,51872378,13000000,6.7,38872378,Crime
2013,51872378,13000000,6.7,38872378,Thriller
2013,37707719,12000000,7.6,25707719,Biography
2013,37707719,12000000,7.6,25707719,Drama
2013,17613460,12000000,7.8,5613460,Adventure
2013,17613460,12000000,7.8,5613460,Comedy
2013,17613460,12000000,7.8,5613460,Drama
2013,15294553,12000000,7.8,3294553,Drama
2013,15294553,12000000,7.8,3294553,Fantasy
2013,15294553,12000000,7.8,3294553,Romance
2013,2835886,9200000,7.7,-6364114,Drama
2013,1702277,12000000,6.8,-10297723,Drama
2013,1702277,12000000,6.8,-10297723,Thriller
2013,13214255,11000000,7.4,2214255,Drama
2013,13214255,11000000,7.4,2214255,Music
2013,23838,7000000,5.5,-6976162,Horror
2013,23838,7000000,5.5,-6976162,Sci-Fi
2013,23838,7000000,5.5,-6976162,Thriller
2013,28873374,10000000,4.1,18873374,Documentary
2013,28873374,10000000,4.1,18873374,Music
2013,8828771,6000000,4.3,2828771,Comedy
2013,7764027,10000000,6.7,-2235973,Comedy
2013,7764027,10000000,6.7,-2235973,Drama
2013,169379,10000000,6.2,-9830621,Drama
2013,169379,10000000,6.2,-9830621,History
2013,169379,10000000,6.2,-9830621,War
2013,11835,10000000,6.9,-9988165,Comedy
2013,11835,10000000,6.9,-9988165,Drama
2013,11835,10000000,6.9,-9988165,Romance
2013,21564616,8500000,5,13064616,Comedy
2013,6262942,9000000,6.9,-2737058,Action
2013,6262942,9000000,6.9,-2737058,Adventure
2013,6262942,9000000,6.9,-2737058,Drama
2013,17536788,8000000,7.1,9536788,Comedy
2013,17536788,8000000,7.1,9536788,Drama
2013,17536788,8000000,7.1,9536788,Romance
2013,16168741,8000000,7.4,8168741,Drama
2013,16168741,8000000,7.4,8168741,Music
2013,144812796,105000000,7.3,39812796,Drama
2013,144812796,105000000,7.3,39812796,Romance
2013,2268296,6500000,6.9,-4231704,Drama
2013,2268296,6500000,6.9,-4231704,Thriller
2013,24475193,3000000,6.6,21475193,Comedy
2013,24475193,3000000,6.6,21475193,Drama
2013,24475193,3000000,6.6,21475193,Romance
2013,22770,5500000,6.1,-5477230,Comedy
2013,22770,5500000,6.1,-5477230,Drama
2013,83574831,5000000,6.6,78574831,Fantasy
2013,83574831,5000000,6.6,78574831,Horror
2013,83574831,5000000,6.6,78574831,Thriller
2013,44456509,5000000,7.6,39456509,Comedy
2013,44456509,5000000,7.6,39456509,Drama
2013,27296514,5000000,8,22296514,Biography
2013,27296514,5000000,8,22296514,Drama
2013,27689474,5000000,6.5,22689474,Horror
2013,27689474,5000000,6.5,22689474,Mystery
2013,21501098,5000000,7.4,16501098,Comedy
2013,21501098,5000000,7.4,16501098,Drama
2013,778565,4800000,5.7,-4021435,Crime
2013,778565,4800000,5.7,-4021435,Drama
2013,15152879,5000000,4,10152879,Drama
2013,15152879,5000000,4,10152879,Horror
2013,15152879,5000000,4,10152879,Thriller
2013,371897,4000000,6.9,-3628103,Drama
2013,100412,4000000,7.7,-3899588,Drama
2013,317125,16000000,6.2,-15682875,Drama
2013,317125,16000000,6.2,-15682875,Romance
2013,64423650,3000000,5.7,61423650,Horror
2013,64423650,3000000,5.7,61423650,Sci-Fi
2013,64423650,3000000,5.7,61423650,Thriller
2013,8114507,3000000,7.9,5114507,Drama
2013,8114507,3000000,7.9,5114507,Romance
2013,40041683,2500000,5.1,37541683,Comedy
2013,40041683,2500000,5.1,37541683,Fantasy
2013,32230907,2500000,6.7,29730907,Comedy
2013,32230907,2500000,6.7,29730907,Documentary
2013,6851969,2500000,7.1,4351969,Comedy
2013,6851969,2500000,7.1,4351969,Drama
2013,6851969,2500000,7.1,4351969,Romance
2013,35266619,30000000,5.9,5266619,Drama
2013,35266619,30000000,5.9,5266619,Fantasy
2013,35266619,30000000,5.9,5266619,Horror
2013,4231500,1000000,7.8,3231500,Drama
2013,4231500,1000000,7.8,3231500,Romance
2013,3447339,1500000,5.8,1947339,Comedy
2013,3447339,1500000,5.8,1947339,Romance
2013,11278,1300000,7,-1288722,Comedy
2013,11278,1300000,7,-1288722,Drama
2013,2859955,1200000,6,1659955,Drama
2013,2859955,1200000,6,1659955,Sport
2013,3830,1200000,7.2,-1196170,Comedy
2013,3830,1200000,7.2,-1196170,Drama
2013,7186670,6000000,5.4,1186670,Adventure
2013,7186670,6000000,5.4,1186670,Horror
2013,4946250,1000000,7.4,3946250,Documentary
2013,4946250,1000000,7.4,3946250,Music
2013,287761,1000000,7.6,-712239,Adventure
2013,287761,1000000,7.6,-712239,Biography
2013,287761,1000000,7.6,-712239,Documentary
2013,287761,1000000,7.6,-712239,Drama
2013,2319187,20000000,7,-17680813,Crime
2013,2319187,20000000,7,-17680813,Drama
2013,2319187,20000000,7,-17680813,Mystery
2013,2319187,20000000,7,-17680813,Thriller
2013,16097842,900000,7.5,15197842,Biography
2013,16097842,900000,7.5,15197842,Drama
2013,16097842,900000,7.5,15197842,Romance
2013,42919096,15000000,6.5,27919096,Action
2013,42919096,15000000,6.5,27919096,Drama
2013,42919096,15000000,6.5,27919096,Thriller
2013,234903076,215000000,6.4,19903076,Adventure
2013,234903076,215000000,6.4,19903076,Family
2013,234903076,215000000,6.4,19903076,Fantasy
2013,258113,1066167,7.1,-808054,Crime
2013,258113,1066167,7.1,-808054,Drama
2013,258113,1066167,7.1,-808054,Thriller
2013,49494,250000,3.9,-200506,Drama
2013,49494,250000,3.9,-200506,Thriller
2013,32154410,30000000,7.1,2154410,Crime
2013,32154410,30000000,7.1,2154410,Drama
2013,32154410,30000000,7.1,2154410,Thriller
2013,59379,200000,6.8,-140621,Comedy
2013,59379,200000,6.8,-140621,Crime
2013,59379,200000,6.8,-140621,Drama
2013,59379,200000,6.8,-140621,Horror
2013,59379,200000,6.8,-140621,Thriller
2012,448130642,250000000,8.5,198130642,Action
2012,448130642,250000000,8.5,198130642,Thriller
2012,73058679,263700000,6.6,-190641321,Action
2012,73058679,263700000,6.6,-190641321,Adventure
2012,73058679,263700000,6.6,-190641321,Sci-Fi
2012,623279547,220000000,8.1,403279547,Action
2012,623279547,220000000,8.1,403279547,Adventure
2012,623279547,220000000,8.1,403279547,Sci-Fi
2012,179020854,225000000,6.8,-45979146,Action
2012,179020854,225000000,6.8,-45979146,Adventure
2012,179020854,225000000,6.8,-45979146,Comedy
2012,179020854,225000000,6.8,-45979146,Family
2012,179020854,225000000,6.8,-45979146,Fantasy
2012,179020854,225000000,6.8,-45979146,Sci-Fi
2012,262030663,230000000,7,32030663,Action
2012,262030663,230000000,7,32030663,Adventure
2012,262030663,230000000,7,32030663,Fantasy
2012,65173160,209000000,5.9,-143826840,Action
2012,65173160,209000000,5.9,-143826840,Adventure
2012,65173160,209000000,5.9,-143826840,Sci-Fi
2012,65173160,209000000,5.9,-143826840,Thriller
2012,304360277,200000000,7.8,104360277,Action
2012,304360277,200000000,7.8,104360277,Adventure
2012,304360277,200000000,7.8,104360277,Thriller
2012,237282182,185000000,7.2,52282182,Adventure
2012,237282182,185000000,7.2,52282182,Animation
2012,237282182,185000000,7.2,52282182,Comedy
2012,237282182,185000000,7.2,52282182,Family
2012,237282182,185000000,7.2,52282182,Fantasy
2012,155111815,170000000,6.1,-14888185,Action
2012,155111815,170000000,6.1,-14888185,Adventure
2012,155111815,170000000,6.1,-14888185,Drama
2012,155111815,170000000,6.1,-14888185,Fantasy
2012,189412677,165000000,7.8,24412677,Adventure
2012,189412677,165000000,7.8,24412677,Animation
2012,189412677,165000000,7.8,24412677,Comedy
2012,189412677,165000000,7.8,24412677,Family
2012,189412677,165000000,7.8,24412677,Sci-Fi
2012,303001229,180000000,7.9,123001229,Adventure
2012,303001229,180000000,7.9,123001229,Fantasy
2012,83640426,150000000,5.8,-66359574,Action
2012,83640426,150000000,5.8,-66359574,Adventure
2012,83640426,150000000,5.8,-66359574,Fantasy
2012,79711678,100000000,6.2,-20288322,Comedy
2012,79711678,100000000,6.2,-20288322,Fantasy
2012,79711678,100000000,6.2,-20288322,Horror
2012,216366733,145000000,6.9,71366733,Adventure
2012,216366733,145000000,6.9,71366733,Animation
2012,216366733,145000000,6.9,71366733,Comedy
2012,216366733,145000000,6.9,71366733,Family
2012,103400692,145000000,7.3,-41599308,Adventure
2012,103400692,145000000,7.3,-41599308,Animation
2012,103400692,145000000,7.3,-41599308,Family
2012,103400692,145000000,7.3,-41599308,Fantasy
2012,292298923,120000000,5.5,172298923,Adventure
2012,292298923,120000000,5.5,172298923,Drama
2012,292298923,120000000,5.5,172298923,Fantasy
2012,292298923,120000000,5.5,172298923,Romance
2012,292298923,120000000,5.5,172298923,Adventure
2012,292298923,120000000,5.5,172298923,Drama
2012,292298923,120000000,5.5,172298923,Fantasy
2012,292298923,120000000,5.5,172298923,Romance
2012,113165635,125000000,6.7,-11834365,Action
2012,113165635,125000000,6.7,-11834365,Adventure
2012,113165635,125000000,6.7,-11834365,Thriller
2012,124976634,120000000,8,4976634,Adventure
2012,124976634,120000000,8,4976634,Drama
2012,124976634,120000000,8,4976634,Fantasy
2012,126464904,130000000,7,-3535096,Adventure
2012,126464904,130000000,7,-3535096,Mystery
2012,126464904,130000000,7,-3535096,Sci-Fi
2012,162804648,100000000,8.5,62804648,Drama
2012,162804648,100000000,8.5,62804648,Western
2012,85017401,92000000,6.7,-6982599,Action
2012,85017401,92000000,6.7,-6982599,Adventure
2012,85017401,92000000,6.7,-6982599,Thriller
2012,27098580,102000000,7.5,-74901420,Drama
2012,27098580,102000000,7.5,-74901420,Sci-Fi
2012,86897182,95000000,6.2,-8102818,Comedy
2012,161317423,95000000,6.6,66317423,Adventure
2012,161317423,95000000,6.6,66317423,Animation
2012,161317423,95000000,6.6,66317423,Comedy
2012,161317423,95000000,6.6,66317423,Family
2012,148313048,85000000,7.1,63313048,Animation
2012,148313048,85000000,7.1,63313048,Comedy
2012,148313048,85000000,7.1,63313048,Family
2012,148313048,85000000,7.1,63313048,Fantasy
2012,126149655,85000000,6.8,41149655,Action
2012,126149655,85000000,6.8,41149655,Crime
2012,126149655,85000000,6.8,41149655,Mystery
2012,126149655,85000000,6.8,41149655,Thriller
2012,64933670,85000000,5.6,-20066330,Adventure
2012,64933670,85000000,5.6,-20066330,Comedy
2012,64933670,85000000,5.6,-20066330,Drama
2012,64933670,85000000,5.6,-20066330,Family
2012,64933670,85000000,5.6,-20066330,Fantasy
2012,13401683,35000000,7.1,-21598317,Action
2012,13401683,35000000,7.1,-21598317,Sci-Fi
2012,407999255,78000000,7.3,329999255,Adventure
2012,407999255,78000000,7.3,329999255,Drama
2012,407999255,78000000,7.3,329999255,Sci-Fi
2012,407999255,78000000,7.3,329999255,Thriller
2012,103812241,79000000,5.8,24812241,Action
2012,103812241,79000000,5.8,24812241,Adventure
2012,103812241,79000000,5.8,24812241,Comedy
2012,103812241,79000000,5.8,24812241,Family
2012,103812241,79000000,5.8,24812241,Fantasy
2012,103812241,79000000,5.8,24812241,Sci-Fi
2012,62321039,70000000,6.4,-7678961,Action
2012,62321039,70000000,6.4,-7678961,Fantasy
2012,62321039,70000000,6.4,-7678961,Horror
2012,38509342,75000000,5.9,-36490658,Comedy
2012,38509342,75000000,5.9,-36490658,Drama
2012,38509342,75000000,5.9,-36490658,Musical
2012,38509342,75000000,5.9,-36490658,Romance
2012,37516013,69000000,5.9,-31483987,Action
2012,37516013,69000000,5.9,-31483987,Fantasy
2012,37516013,69000000,5.9,-31483987,Horror
2012,182204440,65000000,7.4,117204440,Biography
2012,182204440,65000000,7.4,117204440,Drama
2012,182204440,65000000,7.4,117204440,History
2012,182204440,65000000,7.4,117204440,War
2012,148775460,61000000,7.6,87775460,Drama
2012,148775460,61000000,7.6,87775460,Musical
2012,148775460,61000000,7.6,87775460,Romance
2012,59617068,65000000,6.4,-5382932,Comedy
2012,59617068,65000000,6.4,-5382932,Romance
2012,54758461,65000000,6.3,-10241539,Action
2012,54758461,65000000,6.3,-10241539,Comedy
2012,54758461,65000000,6.3,-10241539,Romance
2012,42345531,65000000,5.4,-22654469,Action
2012,42345531,65000000,5.4,-22654469,Horror
2012,42345531,65000000,5.4,-22654469,Sci-Fi
2012,42345531,65000000,5.4,-22654469,Thriller
2012,80033643,60000000,7,20033643,Action
2012,80033643,60000000,7,20033643,Crime
2012,80033643,60000000,7,20033643,Mystery
2012,80033643,60000000,7,20033643,Thriller
2012,55994557,60000000,7,-4005443,Adventure
2012,55994557,60000000,7,-4005443,Animation
2012,55994557,60000000,7,-4005443,Comedy
2012,55994557,60000000,7,-4005443,Family
2012,55994557,60000000,7,-4005443,Fantasy
2012,623279547,220000000,8.1,403279547,Action
2012,623279547,220000000,8.1,403279547,Adventure
2012,623279547,220000000,8.1,403279547,Sci-Fi
2012,49875589,58000000,5.9,-8124411,Action
2012,49875589,58000000,5.9,-8124411,Adventure
2012,49875589,58000000,5.9,-8124411,Drama
2012,49875589,58000000,5.9,-8124411,History
2012,49875589,58000000,5.9,-8124411,War
2012,36931089,70000000,5.6,-33068911,Comedy
2012,34350553,68000000,5.7,-33649447,Action
2012,34350553,68000000,5.7,-33649447,Comedy
2012,34350553,68000000,5.7,-33649447,Sci-Fi
2012,31051126,55000000,6.7,-23948874,Adventure
2012,31051126,55000000,6.7,-23948874,Animation
2012,31051126,55000000,6.7,-23948874,Comedy
2012,31051126,55000000,6.7,-23948874,Family
2012,9483821,55000000,5.7,-45516179,Action
2012,9483821,55000000,5.7,-45516179,Thriller
2012,95720716,40000000,7.4,55720716,Drama
2012,95720716,40000000,7.4,55720716,History
2012,95720716,40000000,7.4,55720716,Thriller
2012,218628680,50000000,7,168628680,Comedy
2012,218628680,50000000,7,168628680,Fantasy
2012,56724080,50000000,6.7,6724080,Comedy
2012,139852971,45000000,6.3,94852971,Action
2012,139852971,45000000,6.3,94852971,Crime
2012,139852971,45000000,6.3,94852971,Thriller
2012,47307550,45000000,6.5,2307550,Crime
2012,47307550,45000000,6.5,2307550,Drama
2012,47307550,45000000,6.5,2307550,Thriller
2012,13401683,35000000,7.1,-21598317,Action
2012,13401683,35000000,7.1,-21598317,Sci-Fi
2012,136019448,44500000,7.7,91519448,Biography
2012,136019448,44500000,7.7,91519448,Drama
2012,136019448,44500000,7.7,91519448,History
2012,136019448,44500000,7.7,91519448,Thriller
2012,138447667,42000000,7.2,96447667,Action
2012,138447667,42000000,7.2,96447667,Comedy
2012,138447667,42000000,7.2,96447667,Crime
2012,45290318,42000000,6.5,3290318,Action
2012,45290318,42000000,6.5,3290318,Comedy
2012,45290318,42000000,6.5,3290318,Sport
2012,26404753,40000000,5.3,-13595247,Action
2012,26404753,40000000,5.3,-13595247,Comedy
2012,26404753,40000000,5.3,-13595247,Crime
2012,26404753,40000000,5.3,-13595247,Romance
2012,26404753,40000000,5.3,-13595247,Thriller
2012,18600911,42000000,6.6,-23399089,Action
2012,18600911,42000000,6.6,-23399089,Crime
2012,18600911,42000000,6.6,-23399089,Thriller
2012,51853450,25000000,6.6,26853450,Comedy
2012,51853450,25000000,6.6,26853450,Drama
2012,51853450,25000000,6.6,26853450,Family
2012,51853450,25000000,6.6,26853450,Fantasy
2012,37101011,40000000,5.8,-2898989,Comedy
2012,37101011,40000000,5.8,-2898989,Drama
2012,18996755,45000000,7.6,-26003245,Drama
2012,18996755,45000000,7.6,-26003245,Thriller
2012,20113965,40000000,6.5,-19886035,Biography
2012,20113965,40000000,6.5,-19886035,Drama
2012,20113965,40000000,6.5,-19886035,Romance
2012,18438149,40000000,5.9,-21561851,Comedy
2012,18438149,40000000,5.9,-21561851,Drama
2012,35287788,39000000,7,-3712212,Animation
2012,35287788,39000000,7,-3712212,Comedy
2012,35287788,39000000,7,-3712212,Family
2012,35287788,39000000,7,-3712212,Horror
2012,35287788,39000000,7,-3712212,Sci-Fi
2012,16377274,32000000,7.1,-15622726,Drama
2012,41102171,40000000,5.7,1102171,Comedy
2012,41102171,40000000,5.7,1102171,Drama
2012,41102171,40000000,5.7,1102171,Romance
2012,67523385,35000000,6.2,32523385,Comedy
2012,25863915,35000000,5.1,-9136085,Action
2012,25863915,35000000,5.1,-9136085,Crime
2012,25863915,35000000,5.1,-9136085,Mystery
2012,25863915,35000000,5.1,-9136085,Thriller
2012,20275446,35000000,6.5,-14724554,Action
2012,20275446,35000000,6.5,-14724554,Crime
2012,20275446,35000000,6.5,-14724554,Thriller
2012,183125,35000000,5.5,-34816875,Action
2012,183125,35000000,5.5,-34816875,Crime
2012,183125,35000000,5.5,-34816875,Drama
2012,183125,35000000,5.5,-34816875,Thriller
2012,13101142,35000000,5.7,-21898858,Comedy
2012,13101142,35000000,5.7,-21898858,Romance
2012,13101142,35000000,5.7,-21898858,Sport
2012,35057332,33000000,6.5,2057332,Drama
2012,35057332,33000000,6.5,2057332,Music
2012,35057332,33000000,6.5,2057332,Romance
2012,17120019,30000000,6.5,-12879981,Action
2012,17120019,30000000,6.5,-12879981,Crime
2012,17120019,30000000,6.5,-12879981,Thriller
2012,93749203,31000000,7.3,62749203,Drama
2012,93749203,31000000,7.3,62749203,Thriller
2012,125014030,30000000,6.8,95014030,Drama
2012,125014030,30000000,6.8,95014030,Romance
2012,66468315,30000000,7.4,36468315,Action
2012,66468315,30000000,7.4,36468315,Crime
2012,66468315,30000000,7.4,36468315,Drama
2012,66468315,30000000,7.4,36468315,Sci-Fi
2012,66468315,30000000,7.4,36468315,Thriller
2012,63536011,30000000,6.3,33536011,Comedy
2012,63536011,30000000,6.3,33536011,Drama
2012,63536011,30000000,6.3,33536011,Romance
2012,42043633,30000000,7,12043633,Fantasy
2012,42043633,30000000,7,12043633,Horror
2012,42043633,30000000,7,12043633,Mystery
2012,42043633,30000000,7,12043633,Thriller
2012,28644770,30000000,6.2,-1355230,Comedy
2012,28644770,30000000,6.2,-1355230,Romance
2012,30920167,25000000,5.7,5920167,Comedy
2012,30920167,25000000,5.7,5920167,Music
2012,16005978,26000000,6.4,-9994022,Crime
2012,16005978,26000000,6.4,-9994022,Mystery
2012,16005978,26000000,6.4,-9994022,Thriller
2012,77264926,25000000,6.1,52264926,Comedy
2012,77264926,25000000,6.1,52264926,Family
2012,60443237,25000000,6.5,35443237,Drama
2012,60443237,25000000,6.5,35443237,Romance
2012,66489425,25000000,6.5,41489425,Action
2012,66489425,25000000,6.5,41489425,Crime
2012,66489425,25000000,6.5,41489425,Drama
2012,66489425,25000000,6.5,41489425,Thriller
2012,49122319,14000000,5.9,35122319,Horror
2012,49122319,14000000,5.9,35122319,Thriller
2012,717753,25000000,6.1,-24282247,Adventure
2012,717753,25000000,6.1,-24282247,Drama
2012,49002815,22000000,6.4,27002815,Comedy
2012,49002815,22000000,6.4,27002815,Family
2012,13746550,2000000,6.1,11746550,Action
2012,13746550,2000000,6.1,11746550,Comedy
2012,13746550,2000000,6.1,11746550,Romance
2012,16684352,17000000,6.3,-315648,Comedy
2012,16684352,17000000,6.3,-315648,Romance
2012,132088910,21000000,7.8,111088910,Comedy
2012,132088910,21000000,7.8,111088910,Drama
2012,132088910,21000000,7.8,111088910,Romance
2012,65623128,20000000,4.8,45623128,Comedy
2012,65623128,20000000,4.8,45623128,Crime
2012,65623128,20000000,4.8,45623128,Drama
2012,17529157,20000000,5,-2470843,Adventure
2012,17529157,20000000,5,-2470843,Drama
2012,17529157,20000000,5,-2470843,Horror
2012,17529157,20000000,5,-2470843,Mystery
2012,17529157,20000000,5,-2470843,Thriller
2012,14291570,20000000,6.1,-5708430,Action
2012,14291570,20000000,6.1,-5708430,Adventure
2012,14291570,20000000,6.1,-5708430,Sci-Fi
2012,14291570,20000000,6.1,-5708430,Thriller
2012,6002756,20000000,7.2,-13997244,Biography
2012,6002756,20000000,7.2,-13997244,Drama
2012,6002756,20000000,7.2,-13997244,Sport
2012,3749061,20000000,4.9,-16250939,Action
2012,3749061,20000000,4.9,-16250939,Thriller
2012,1064277,20000000,6.7,-18935723,Adventure
2012,1064277,20000000,6.7,-18935723,Family
2012,1064277,20000000,6.7,-18935723,Fantasy
2012,1064277,20000000,6.7,-18935723,Musical
2012,64998368,17000000,7.2,47998368,Comedy
2012,64998368,17000000,7.2,47998368,Music
2012,64998368,17000000,7.2,47998368,Romance
2012,4930798,17000000,4.1,-12069202,Horror
2012,4930798,17000000,4.1,-12069202,Thriller
2012,45507053,16000000,7.8,29507053,Adventure
2012,45507053,16000000,7.8,29507053,Comedy
2012,45507053,16000000,7.8,29507053,Drama
2012,45507053,16000000,7.8,29507053,Romance
2012,2964,16000000,5.1,-15997036,Comedy
2012,2964,16000000,5.1,-15997036,Horror
2012,2964,16000000,5.1,-15997036,Romance
2012,54322273,17000000,6.4,37322273,Drama
2012,54322273,17000000,6.4,37322273,Fantasy
2012,54322273,17000000,6.4,37322273,Horror
2012,54322273,17000000,6.4,37322273,Thriller
2012,40983001,7000000,7.7,33983001,Crime
2012,40983001,7000000,7.7,33983001,Drama
2012,40983001,7000000,7.7,33983001,Thriller
2012,21383298,15000000,7.3,6383298,Crime
2012,21383298,15000000,7.3,6383298,Drama
2012,21383298,15000000,7.3,6383298,Thriller
2012,14938570,15000000,6.2,-61430,Crime
2012,14938570,15000000,6.2,-61430,Thriller
2012,15608545,15000000,5.4,608545,Action
2012,7556708,15000000,6.6,-7443292,Drama
2012,49122319,14000000,5.9,35122319,Horror
2012,49122319,14000000,5.9,35122319,Thriller
2012,9402410,14000000,5.4,-4597590,Adventure
2012,9402410,14000000,5.4,-4597590,Comedy
2012,14989761,15000000,7.2,-10239,Comedy
2012,14989761,15000000,7.2,-10239,Crime
2012,17738570,13000000,8,4738570,Drama
2012,17738570,13000000,8,4738570,Romance
2012,71442,9600000,7.9,-9528558,Animation
2012,71442,9600000,7.9,-9528558,Comedy
2012,71442,9600000,7.9,-9528558,Crime
2012,71442,9600000,7.9,-9528558,Drama
2012,71442,9600000,7.9,-9528558,Family
2012,91547205,12000000,6.6,79547205,Comedy
2012,91547205,12000000,6.6,79547205,Romance
2012,70011073,12000000,6.5,58011073,Action
2012,70011073,12000000,6.5,58011073,Adventure
2012,70011073,12000000,6.5,58011073,Drama
2012,70011073,12000000,6.5,58011073,Thriller
2012,70011073,12000000,6.5,58011073,War
2012,64572496,12000000,7.1,52572496,Drama
2012,64572496,12000000,7.1,52572496,Sci-Fi
2012,64572496,12000000,7.1,52572496,Thriller
2012,54724272,12000000,6.7,42724272,Comedy
2012,54724272,12000000,6.7,42724272,Crime
2012,25240988,12000000,5.9,13240988,Documentary
2012,25240988,12000000,5.9,13240988,Music
2012,7918283,12000000,6.6,-4081717,Drama
2012,7918283,12000000,6.6,-4081717,Thriller
2012,18381787,11000000,6.8,7381787,Comedy
2012,18381787,11000000,6.8,7381787,Drama
2012,5669081,10818775,6.6,-5149694,Drama
2012,5669081,10818775,6.6,-5149694,History
2012,5669081,10818775,6.6,-5149694,War
2012,24397469,17000000,5.7,7397469,Drama
2012,24397469,17000000,5.7,7397469,Music
2012,21589307,10000000,7.4,11589307,Drama
2012,6619173,10000000,6.7,-3380827,Adventure
2012,6619173,10000000,6.7,-3380827,Comedy
2012,6619173,10000000,6.7,-3380827,Drama
2012,6619173,10000000,6.7,-3380827,Romance
2012,6619173,10000000,6.7,-3380827,Sci-Fi
2012,6842058,10000000,6.1,-3157942,Action
2012,6842058,10000000,6.1,-3157942,Horror
2012,6842058,10000000,6.1,-3157942,Thriller
2012,3333823,10000000,5.5,-6666177,Drama
2012,3333823,10000000,5.5,-6666177,Mystery
2012,3333823,10000000,5.5,-6666177,Sci-Fi
2012,1939441,10000000,6.9,-8060559,Biography
2012,1939441,10000000,6.9,-8060559,Crime
2012,1939441,10000000,6.9,-8060559,Drama
2012,225377,8900000,7.9,-8674623,Drama
2012,225377,8900000,7.9,-8674623,Romance
2012,3047539,7217600,6.9,-4170061,Drama
2012,3047539,7217600,6.9,-4170061,Romance
2012,113709992,7000000,6.1,106709992,Comedy
2012,113709992,7000000,6.1,106709992,Drama
2012,304360277,200000000,7.8,104360277,Action
2012,304360277,200000000,7.8,104360277,Adventure
2012,304360277,200000000,7.8,104360277,Thriller
2012,31607598,6900000,5.6,24707598,Drama
2012,31607598,6900000,5.6,24707598,Horror
2012,31607598,6900000,5.6,24707598,Thriller
2012,11434867,6000000,7.1,5434867,Drama
2012,11434867,6000000,7.1,5434867,Mystery
2012,11434867,6000000,7.1,5434867,Romance
2012,11434867,6000000,7.1,5434867,Thriller
2012,5895238,6000000,5.5,-104762,Comedy
2012,5895238,6000000,5.5,-104762,Western
2012,65804,12000000,6.3,-11934196,Crime
2012,65804,12000000,6.3,-11934196,Drama
2012,65804,12000000,6.3,-11934196,Thriller
2012,53884821,5000000,4.6,48884821,Horror
2012,14123773,5000000,5.3,9123773,Crime
2012,14123773,5000000,5.3,9123773,Drama
2012,26345,3000000,6.1,-2973655,Action
2012,26345,3000000,6.1,-2973655,Crime
2012,26345,3000000,6.1,-2973655,Drama
2012,4063,4000000,5.2,-3995937,Drama
2012,4063,4000000,5.2,-3995937,Mystery
2012,4063,4000000,5.2,-3995937,Romance
2012,4063,4000000,5.2,-3995937,Thriller
2012,34350553,68000000,5.7,-33649447,Action
2012,34350553,68000000,5.7,-33649447,Comedy
2012,34350553,68000000,5.7,-33649447,Sci-Fi
2012,610968,3800000,8.3,-3189032,Drama
2012,48056940,3000000,6.8,45056940,Horror
2012,48056940,3000000,6.8,45056940,Mystery
2012,418268,3000000,5.3,-2581732,Comedy
2012,418268,3000000,5.3,-2581732,Romance
2012,200803,3000000,5.3,-2799197,Comedy
2012,33349949,2500000,5.1,30849949,Documentary
2012,3325638,2500000,7.1,825638,Comedy
2012,3325638,2500000,7.1,825638,Crime
2012,3325638,2500000,7.1,825638,Drama
2012,3325638,2500000,7.1,825638,Sci-Fi
2012,2436,2000000,5.7,-1997564,Comedy
2012,2436,2000000,5.7,-1997564,Fantasy
2012,2436,2000000,5.7,-1997564,Musical
2012,2436,2000000,5.7,-1997564,Sci-Fi
2012,12784397,1800000,7.3,10984397,Drama
2012,12784397,1800000,7.3,10984397,Fantasy
2012,1163508,2500000,5.1,-1336492,Drama
2012,1163508,2500000,5.1,-1336492,Fantasy
2012,1163508,2500000,5.1,-1336492,Horror
2012,1163508,2500000,5.1,-1336492,Thriller
2012,80033643,60000000,7,20033643,Action
2012,80033643,60000000,7,20033643,Crime
2012,80033643,60000000,7,20033643,Mystery
2012,80033643,60000000,7,20033643,Thriller
2012,1521,1500000,5.7,-1498479,Comedy
2012,1521,1500000,5.7,-1498479,Horror
2012,2833383,427000,5.7,2406383,Drama
2012,2833383,427000,5.7,2406383,Music
2012,594904,1200000,6,-605096,Comedy
2012,594904,1200000,6,-605096,Drama
2012,18112929,1000000,5,17112929,Horror
2012,18112929,1000000,5,17112929,Mystery
2012,18112929,1000000,5,17112929,Sci-Fi
2012,18112929,1000000,5,17112929,Thriller
2012,53245055,1000000,4.2,52245055,Horror
2012,5997134,1000000,7.2,4997134,Biography
2012,5997134,1000000,7.2,4997134,Comedy
2012,5997134,1000000,7.2,4997134,Drama
2012,5997134,1000000,7.2,4997134,Romance
2012,484221,1000000,8.2,-515779,Biography
2012,484221,1000000,8.2,-515779,Crime
2012,484221,1000000,8.2,-515779,Documentary
2012,484221,1000000,8.2,-515779,History
2012,96734,1000000,5.6,-903266,Action
2012,96734,1000000,5.6,-903266,Drama
2012,6643,900000,6.4,-893357,Comedy
2012,6643,900000,6.4,-893357,Fantasy
2012,6643,900000,6.4,-893357,Thriller
2012,1243961,850000,6,393961,Comedy
2012,4007792,750000,7,3257792,Comedy
2012,4007792,750000,7,3257792,Drama
2012,4007792,750000,7,3257792,Romance
2012,151389,500000,7.1,-348611,Documentary
2012,133778,500000,8.4,-366222,Documentary
2012,133778,500000,8.4,-366222,Sport
2012,1332,500000,4.6,-498668,Comedy
2012,1332,500000,4.6,-498668,Horror
2012,12843,6000000,6.1,-5987157,Horror
2012,12843,6000000,6.1,-5987157,Thriller
2012,318622,270000,6.4,48622,Biography
2012,318622,270000,6.4,48622,Crime
2012,318622,270000,6.4,48622,Drama
2012,318622,270000,6.4,48622,Thriller
2012,111300,225000,7.5,-113700,Documentary
2012,78030,200000,6.5,-121970,Drama
2011,241063875,250000000,6.7,-8936125,Action
2011,241063875,250000000,6.7,-8936125,Adventure
2011,241063875,250000000,6.7,-8936125,Fantasy
2011,191450875,200000000,6.3,-8549125,Adventure
2011,191450875,200000000,6.3,-8549125,Animation
2011,191450875,200000000,6.3,-8549125,Comedy
2011,191450875,200000000,6.3,-8549125,Family
2011,191450875,200000000,6.3,-8549125,Sport
2011,116593191,200000000,5.6,-83406809,Action
2011,116593191,200000000,5.6,-83406809,Adventure
2011,116593191,200000000,5.6,-83406809,Sci-Fi
2011,352358779,195000000,6.3,157358779,Action
2011,352358779,195000000,6.3,157358779,Adventure
2011,352358779,195000000,6.3,157358779,Sci-Fi
2011,73820094,170000000,7.5,-96179906,Adventure
2011,73820094,170000000,7.5,-96179906,Drama
2011,73820094,170000000,7.5,-96179906,Family
2011,73820094,170000000,7.5,-96179906,Mystery
2011,146405371,160000000,7.8,-13594629,Action
2011,146405371,160000000,7.8,-13594629,Adventure
2011,146405371,160000000,7.8,-13594629,Sci-Fi
2011,181015141,150000000,7,31015141,Action
2011,181015141,150000000,7,31015141,Adventure
2011,181015141,150000000,7,31015141,Fantasy
2011,165230261,150000000,7.3,15230261,Action
2011,165230261,150000000,7.3,15230261,Adventure
2011,165230261,150000000,7.3,15230261,Animation
2011,165230261,150000000,7.3,15230261,Comedy
2011,165230261,150000000,7.3,15230261,Family
2011,21379315,150000000,5.4,-128620685,Action
2011,21379315,150000000,5.4,-128620685,Adventure
2011,21379315,150000000,5.4,-128620685,Animation
2011,21379315,150000000,5.4,-128620685,Comedy
2011,21379315,150000000,5.4,-128620685,Family
2011,21379315,150000000,5.4,-128620685,Sci-Fi
2011,209364921,145000000,7.4,64364921,Action
2011,209364921,145000000,7.4,64364921,Adventure
2011,209364921,145000000,7.4,64364921,Thriller
2011,176636816,140000000,6.9,36636816,Action
2011,176636816,140000000,6.9,36636816,Adventure
2011,176636816,140000000,6.9,36636816,Sci-Fi
2011,63992328,135000000,5.9,-71007672,Animation
2011,63992328,135000000,5.9,-71007672,Comedy
2011,63992328,135000000,5.9,-71007672,Family
2011,63992328,135000000,5.9,-71007672,Musical
2011,123207194,135000000,7.2,-11792806,Adventure
2011,123207194,135000000,7.2,-11792806,Animation
2011,123207194,135000000,7.2,-11792806,Comedy
2011,123207194,135000000,7.2,-11792806,Family
2011,123207194,135000000,7.2,-11792806,Western
2011,149234747,130000000,6.7,19234747,Action
2011,149234747,130000000,6.7,19234747,Adventure
2011,149234747,130000000,6.7,19234747,Animation
2011,149234747,130000000,6.7,19234747,Comedy
2011,149234747,130000000,6.7,19234747,Family
2011,149234747,130000000,6.7,19234747,Fantasy
2011,77564037,135000000,7.4,-57435963,Action
2011,77564037,135000000,7.4,-57435963,Adventure
2011,77564037,135000000,7.4,-57435963,Family
2011,77564037,135000000,7.4,-57435963,Mystery
2011,209805005,125000000,7.3,84805005,Action
2011,209805005,125000000,7.3,84805005,Crime
2011,209805005,125000000,7.3,84805005,Thriller
2011,186830669,125000000,7.5,61830669,Action
2011,186830669,125000000,7.5,61830669,Adventure
2011,186830669,125000000,7.5,61830669,Crime
2011,186830669,125000000,7.5,61830669,Mystery
2011,186830669,125000000,7.5,61830669,Thriller
2011,98780042,120000000,5.8,-21219958,Action
2011,98780042,120000000,5.8,-21219958,Comedy
2011,98780042,120000000,5.8,-21219958,Crime
2011,98780042,120000000,5.8,-21219958,Sci-Fi
2011,98780042,120000000,5.8,-21219958,Thriller
2011,142614158,110000000,5.5,32614158,Adventure
2011,142614158,110000000,5.5,32614158,Animation
2011,142614158,110000000,5.5,32614158,Comedy
2011,142614158,110000000,5.5,32614158,Family
2011,142614158,110000000,5.5,32614158,Fantasy
2011,85463309,110000000,7.1,-24536691,Action
2011,85463309,110000000,7.1,-24536691,Drama
2011,85463309,110000000,7.1,-24536691,Sci-Fi
2011,85463309,110000000,7.1,-24536691,Sport
2011,9213,94000000,7.6,-93990787,Drama
2011,9213,94000000,7.6,-93990787,History
2011,9213,94000000,7.6,-93990787,Romance
2011,9213,94000000,7.6,-93990787,War
2011,176740650,93000000,7.6,83740650,Action
2011,176740650,93000000,7.6,83740650,Drama
2011,176740650,93000000,7.6,83740650,Sci-Fi
2011,176740650,93000000,7.6,83740650,Thriller
2011,102515793,90000000,7.8,12515793,Crime
2011,102515793,90000000,7.8,12515793,Drama
2011,102515793,90000000,7.8,12515793,Mystery
2011,102515793,90000000,7.8,12515793,Thriller
2011,143618384,90000000,7,53618384,Adventure
2011,143618384,90000000,7,53618384,Animation
2011,143618384,90000000,7,53618384,Comedy
2011,143618384,90000000,7,53618384,Family
2011,143618384,90000000,7,53618384,Musical
2011,20315324,75000000,5.8,-54684676,Action
2011,20315324,75000000,5.8,-54684676,Adventure
2011,20315324,75000000,5.8,-54684676,Romance
2011,78009155,75000000,6.2,3009155,Action
2011,78009155,75000000,6.2,3009155,Comedy
2011,78009155,75000000,6.2,3009155,Crime
2011,46440491,100000000,7.1,-53559509,Adventure
2011,46440491,100000000,7.1,-53559509,Animation
2011,46440491,100000000,7.1,-53559509,Comedy
2011,46440491,100000000,7.1,-53559509,Family
2011,46440491,100000000,7.1,-53559509,Fantasy
2011,254455986,80000000,6.5,174455986,Comedy
2011,133103929,75000000,4.4,58103929,Adventure
2011,133103929,75000000,4.4,58103929,Animation
2011,133103929,75000000,4.4,58103929,Comedy
2011,133103929,75000000,4.4,58103929,Family
2011,133103929,75000000,4.4,58103929,Fantasy
2011,133103929,75000000,4.4,58103929,Music
2011,103028109,80000000,6.4,23028109,Comedy
2011,103028109,80000000,6.4,23028109,Romance
2011,80360866,80000000,5.2,360866,Comedy
2011,80360866,80000000,5.2,360866,Family
2011,80360866,80000000,5.2,360866,Romance
2011,74158157,79000000,3.4,-4841843,Comedy
2011,83503161,75000000,6.1,8503161,Action
2011,83503161,75000000,6.1,8503161,Drama
2011,83503161,75000000,6.1,8503161,Fantasy
2011,83503161,75000000,6.1,8503161,Romance
2011,36381716,82000000,6.1,-45618284,Action
2011,36381716,82000000,6.1,-45618284,Fantasy
2011,83552429,70000000,5.8,13552429,Action
2011,83552429,70000000,5.8,13552429,Sci-Fi
2011,79883359,66000000,7.2,13883359,Drama
2011,79883359,66000000,7.2,13883359,War
2011,48430355,70000000,5.3,-21569645,Comedy
2011,48430355,70000000,5.3,-21569645,Drama
2011,25093607,35000000,6.5,-9906393,Action
2011,25093607,35000000,6.5,-9906393,Crime
2011,25093607,35000000,6.5,-9906393,Thriller
2011,45045037,36000000,5.9,9045037,Comedy
2011,45045037,36000000,5.9,9045037,Romance
2011,108012170,63000000,5.5,45012170,Adventure
2011,108012170,63000000,5.5,45012170,Animation
2011,108012170,63000000,5.5,45012170,Comedy
2011,108012170,63000000,5.5,45012170,Family
2011,108012170,63000000,5.5,45012170,Fantasy
2011,75638743,60000000,6.6,15638743,Drama
2011,75638743,60000000,6.6,15638743,Thriller
2011,29136626,60000000,5.7,-30863374,Action
2011,29136626,60000000,5.7,-30863374,Fantasy
2011,29136626,60000000,5.7,-30863374,Horror
2011,29136626,60000000,5.7,-30863374,Sci-Fi
2011,29136626,60000000,5.7,-30863374,Thriller
2011,51774002,57000000,4.3,-5225998,Action
2011,51774002,57000000,4.3,-5225998,Fantasy
2011,51774002,57000000,4.3,-5225998,Thriller
2011,68218041,55000000,6,13218041,Comedy
2011,68218041,55000000,6,13218041,Family
2011,68218041,55000000,6,13218041,Fantasy
2011,37035845,52000000,6.4,-14964155,Comedy
2011,37035845,52000000,6.4,-14964155,Fantasy
2011,62453315,50200000,7.1,12253315,Romance
2011,62453315,50200000,7.1,12253315,Sci-Fi
2011,62453315,50200000,7.1,12253315,Thriller
2011,126975169,50000000,7.1,76975169,Mystery
2011,126975169,50000000,7.1,76975169,Sci-Fi
2011,126975169,50000000,7.1,76975169,Thriller
2011,84244877,50000000,7.4,34244877,Comedy
2011,84244877,50000000,7.4,34244877,Drama
2011,84244877,50000000,7.4,34244877,Romance
2011,75605492,50000000,7.6,25605492,Biography
2011,75605492,50000000,7.6,25605492,Drama
2011,75605492,50000000,7.6,25605492,Sport
2011,55092830,60000000,6.1,-4907170,Action
2011,55092830,60000000,6.1,-4907170,Adventure
2011,55092830,60000000,6.1,-4907170,Sci-Fi
2011,55092830,60000000,6.1,-4907170,Thriller
2011,21557240,49900000,5.6,-28342760,Adventure
2011,21557240,49900000,5.6,-28342760,Comedy
2011,21557240,49900000,5.6,-28342760,Fantasy
2011,21283440,55000000,6,-33716560,Drama
2011,21283440,55000000,6,-33716560,Mystery
2011,21283440,55000000,6,-33716560,Thriller
2011,10706786,50000000,5.5,-39293214,Action
2011,10706786,50000000,5.5,-39293214,Fantasy
2011,10706786,50000000,5.5,-39293214,Thriller
2011,88625922,45000000,7.1,43625922,Adventure
2011,88625922,45000000,7.1,43625922,Comedy
2011,88625922,45000000,7.1,43625922,Family
2011,88625922,45000000,7.1,43625922,Musical
2011,8129455,45000000,6.3,-36870545,Action
2011,8129455,45000000,6.3,-36870545,Adventure
2011,8129455,45000000,6.3,-36870545,Comedy
2011,8129455,45000000,6.3,-36870545,Crime
2011,29113588,40000000,6.6,-10886412,Action
2011,29113588,40000000,6.6,-10886412,Crime
2011,29113588,40000000,6.6,-10886412,Thriller
2011,37652565,42000000,5.4,-4347435,Fantasy
2011,37652565,42000000,5.4,-4347435,Horror
2011,37652565,42000000,5.4,-4347435,Mystery
2011,37652565,42000000,5.4,-4347435,Thriller
2011,7204138,41000000,6.2,-33795862,Comedy
2011,57981889,40000000,7.3,17981889,Crime
2011,57981889,40000000,7.3,17981889,Drama
2011,57981889,40000000,7.3,17981889,Thriller
2011,61094903,30000000,6.9,31094903,Action
2011,61094903,30000000,6.9,31094903,Mystery
2011,61094903,30000000,6.9,31094903,Thriller
2011,37371385,40000000,7,-2628615,Adventure
2011,37371385,40000000,7,-2628615,Comedy
2011,37371385,40000000,7,-2628615,Sci-Fi
2011,38176892,40000000,6.2,-1823108,Horror
2011,38176892,40000000,6.2,-1823108,Mystery
2011,42575718,40000000,5.9,2575718,Horror
2011,31836745,40000000,6.9,-8163255,Adventure
2011,31836745,40000000,6.9,-8163255,Drama
2011,31836745,40000000,6.9,-8163255,Mystery
2011,36665854,40000000,6.4,-3334146,Action
2011,36665854,40000000,6.4,-3334146,Crime
2011,36665854,40000000,6.4,-3334146,Drama
2011,36665854,40000000,6.4,-3334146,Thriller
2011,58700247,38000000,6.9,20700247,Drama
2011,58700247,38000000,6.9,20700247,Romance
2011,72279690,37000000,6.9,35279690,Drama
2011,72279690,37000000,6.9,35279690,Family
2011,33037754,37000000,6,-3962246,Drama
2011,33037754,37000000,6,-3962246,Horror
2011,33037754,37000000,6,-3962246,Mystery
2011,33037754,37000000,6,-3962246,Thriller
2011,1068392,36000000,5.9,-34931608,Biography
2011,1068392,36000000,5.9,-34931608,Drama
2011,1068392,36000000,5.9,-34931608,War
2011,117528646,35000000,6.9,82528646,Comedy
2011,117528646,35000000,6.9,82528646,Crime
2011,55802754,35000000,6.6,20802754,Comedy
2011,55802754,35000000,6.6,20802754,Romance
2011,37553932,40000000,6.7,-2446068,Action
2011,37553932,40000000,6.7,-2446068,Sci-Fi
2011,37553932,40000000,6.7,-2446068,Thriller
2011,39026186,35000000,5.9,4026186,Comedy
2011,39026186,35000000,5.9,4026186,Drama
2011,39026186,35000000,5.9,4026186,Romance
2011,37304950,35000000,6.6,2304950,Biography
2011,37304950,35000000,6.6,2304950,Crime
2011,37304950,35000000,6.6,2304950,Drama
2011,28064226,35000000,5,-6935774,Action
2011,28064226,35000000,5,-6935774,Mystery
2011,28064226,35000000,5,-6935774,Thriller
2011,13303319,32000000,6.7,-18696681,Drama
2011,13303319,32000000,6.7,-18696681,Fantasy
2011,21426805,30000000,4.9,-8573195,Action
2011,21426805,30000000,4.9,-8573195,Adventure
2011,21426805,30000000,4.9,-8573195,Horror
2011,21426805,30000000,4.9,-8573195,Sci-Fi
2011,21426805,30000000,4.9,-8573195,Thriller
2011,169076745,32500000,6.8,136576745,Comedy
2011,169076745,32500000,6.8,136576745,Romance
2011,37911876,32000000,4.4,5911876,Action
2011,37911876,32000000,4.4,5911876,Comedy
2011,37911876,32000000,4.4,5911876,Crime
2011,54696902,32000000,7.5,22696902,Mystery
2011,54696902,32000000,7.5,22696902,Sci-Fi
2011,54696902,32000000,7.5,22696902,Thriller
2011,56816662,17000000,7.7,39816662,Comedy
2011,56816662,17000000,7.7,39816662,Fantasy
2011,56816662,17000000,7.7,39816662,Romance
2011,40247512,30000000,6.8,10247512,Action
2011,40247512,30000000,6.8,10247512,Drama
2011,40247512,30000000,6.8,10247512,Thriller
2011,35565975,30000000,6.1,5565975,Comedy
2011,35565975,30000000,6.1,5565975,Drama
2011,35565975,30000000,6.1,5565975,Romance
2011,26687172,30000000,7.3,-3312828,Adventure
2011,26687172,30000000,7.3,-3312828,Animation
2011,26687172,30000000,7.3,-3312828,Comedy
2011,26687172,30000000,7.3,-3312828,Family
2011,26687172,30000000,7.3,-3312828,Musical
2011,23070045,30000000,5.9,-6929955,Adventure
2011,23070045,30000000,5.9,-6929955,Drama
2011,23070045,30000000,5.9,-6929955,Thriller
2011,18298649,30000000,6.4,-11701351,Comedy
2011,18298649,30000000,6.4,-11701351,Horror
2011,10134754,30000000,4.8,-19865246,Animation
2011,10134754,30000000,4.8,-19865246,Comedy
2011,10134754,30000000,4.8,-19865246,Family
2011,127437,18000000,6,-17872563,Action
2011,127437,18000000,6,-17872563,Adventure
2011,127437,18000000,6,-17872563,Drama
2011,127437,18000000,6,-17872563,History
2011,127437,18000000,6,-17872563,War
2011,537580,30000000,6.8,-29462420,Action
2011,537580,30000000,6.8,-29462420,Biography
2011,537580,30000000,6.8,-29462420,Crime
2011,537580,30000000,6.8,-29462420,Drama
2011,37053924,28000000,6.1,9053924,Action
2011,37053924,28000000,6.1,9053924,Comedy
2011,37053924,28000000,6.1,9053924,Crime
2011,4463292,30000000,6.9,-25536708,Drama
2011,4463292,30000000,6.9,-25536708,History
2011,4463292,30000000,6.9,-25536708,Thriller
2011,38536376,27000000,3.6,11536376,Action
2011,38536376,27000000,3.6,11536376,Adventure
2011,38536376,27000000,3.6,11536376,Comedy
2011,38536376,27000000,3.6,11536376,Family
2011,38536376,27000000,3.6,11536376,Sci-Fi
2011,54540525,56000000,5.7,-1459475,Comedy
2011,54540525,56000000,5.7,-1459475,Romance
2011,169705587,25000000,8.1,144705587,Drama
2011,70625986,25000000,6.2,45625986,Comedy
2011,70625986,25000000,6.2,45625986,Romance
2011,51533608,25000000,6.8,26533608,Action
2011,51533608,25000000,6.8,26533608,Adventure
2011,51533608,25000000,6.8,26533608,Drama
2011,51533608,25000000,6.8,26533608,Thriller
2011,18860403,25000000,4,-6139597,Horror
2011,18860403,25000000,4,-6139597,Thriller
2011,13651662,25000000,8.2,-11348338,Drama
2011,13651662,25000000,8.2,-11348338,Sport
2011,10324441,25000000,5.8,-14675559,Action
2011,10324441,25000000,5.8,-14675559,Drama
2011,10324441,25000000,5.8,-14675559,Thriller
2011,9639242,24000000,4.9,-14360758,Comedy
2011,9639242,24000000,4.9,-14360758,Romance
2011,40962534,12500000,7.1,28462534,Drama
2011,18934858,23000000,5.8,-4065142,Action
2011,18934858,23000000,5.8,-4065142,Thriller
2011,24104113,20000000,7.1,4104113,Drama
2011,24104113,20000000,7.1,4104113,Mystery
2011,24104113,20000000,7.1,4104113,Thriller
2011,958319,21000000,6.7,-20041681,Drama
2011,82624961,20000000,7.3,62624961,Comedy
2011,82624961,20000000,7.3,62624961,Drama
2011,35033759,19000000,6.3,16033759,Adventure
2011,35033759,19000000,6.3,16033759,Comedy
2011,23179303,20000000,5.8,3179303,Adventure
2011,23179303,20000000,5.8,3179303,Comedy
2011,23179303,20000000,5.8,3179303,Family
2011,23179303,20000000,5.8,3179303,Romance
2011,13987482,20000000,6,-6012518,Comedy
2011,13987482,20000000,6,-6012518,Romance
2011,5702083,15000000,6.5,-9297917,Biography
2011,5702083,15000000,6.5,-9297917,Drama
2011,5702083,15000000,6.5,-9297917,Thriller
2011,100292856,20000000,5.7,80292856,Comedy
2011,1357042,15000000,7.1,-13642958,Biography
2011,1357042,15000000,7.1,-13642958,Drama
2011,1357042,15000000,7.1,-13642958,Thriller
2011,6923891,23000000,6.3,-16076109,Comedy
2011,6923891,23000000,6.3,-16076109,Drama
2011,6923891,23000000,6.3,-16076109,Romance
2011,52691009,21000000,6.6,31691009,Comedy
2011,52691009,21000000,6.6,31691009,Family
2011,43853424,18000000,7.1,25853424,Biography
2011,43853424,18000000,7.1,25853424,Drama
2011,43853424,18000000,7.1,25853424,Family
2011,43853424,18000000,7.1,25853424,Sport
2011,27854896,17000000,5.6,10854896,Drama
2011,27854896,17000000,5.6,10854896,Fantasy
2011,27854896,17000000,5.6,10854896,Romance
2011,44667095,15000000,8,29667095,Comedy
2011,44667095,15000000,8,29667095,Drama
2011,44667095,15000000,8,29667095,Romance
2011,37300107,16000000,4.8,21300107,Drama
2011,37300107,16000000,4.8,21300107,Horror
2011,37300107,16000000,4.8,21300107,Thriller
2011,35054909,15000000,7.8,20054909,Crime
2011,35054909,15000000,7.8,20054909,Drama
2011,13766014,15000000,7,-1233986,Drama
2011,13766014,15000000,7,-1233986,Romance
2011,28870,15000000,5.1,-14971130,Crime
2011,28870,15000000,5.1,-14971130,Drama
2011,28870,15000000,5.1,-14971130,Thriller
2011,29959436,13000000,6.4,16959436,Biography
2011,29959436,13000000,6.4,16959436,Drama
2011,29959436,13000000,6.4,16959436,History
2011,46495,14000000,6.5,-13953505,Drama
2011,73000942,13000000,1.6,60000942,Documentary
2011,73000942,13000000,1.6,60000942,Music
2011,1024175,13000000,6.6,-11975825,Action
2011,1024175,13000000,6.6,-11975825,Comedy
2011,1024175,13000000,6.6,-11975825,Sci-Fi
2011,1024175,13000000,6.6,-11975825,Thriller
2011,301305,13000000,4.3,-12698695,Drama
2011,301305,13000000,4.3,-12698695,Romance
2011,301305,13000000,4.3,-12698695,War
2011,16300302,12000000,6.3,4300302,Comedy
2011,16300302,12000000,6.3,4300302,Drama
2011,17149,20000000,5.6,-19982851,Action
2011,17149,20000000,5.6,-19982851,Drama
2011,17149,20000000,5.6,-19982851,War
2011,46377022,10000000,7.3,36377022,Comedy
2011,46377022,10000000,7.3,36377022,Drama
2011,14597405,6400000,7,8197405,Biography
2011,14597405,6400000,7,8197405,Drama
2011,4244155,10000000,6.5,-5755845,Comedy
2011,4244155,10000000,6.5,-5755845,Drama
2011,2331318,10000000,3.3,-7668682,Comedy
2011,1754319,10000000,7.2,-8245681,Drama
2011,1754319,10000000,7.2,-8245681,Romance
2011,1987762,11000000,6.7,-9012238,Crime
2011,1987762,11000000,6.7,-9012238,Drama
2011,1987762,11000000,6.7,-9012238,Romance
2011,1987762,11000000,6.7,-9012238,Thriller
2011,3029870,7400000,7.1,-4370130,Drama
2011,3029870,7400000,7.1,-4370130,Sci-Fi
2011,11860839,9000000,5.4,2860839,Documentary
2011,11860839,9000000,5.4,2860839,Music
2011,34963967,8000000,7.7,26963967,Comedy
2011,34963967,8000000,7.7,26963967,Drama
2011,34963967,8000000,7.7,26963967,Romance
2011,10106233,8000000,5.4,2106233,Comedy
2011,10106233,8000000,5.4,2106233,Drama
2011,3014541,8000000,6.7,-4985459,Drama
2011,37295394,6600000,5.7,30695394,Comedy
2011,37295394,6600000,5.7,30695394,Drama
2011,1738692,7000000,7.5,-5261308,Drama
2011,1738692,7000000,7.5,-5261308,Thriller
2011,4000304,6500000,7.3,-2499696,Drama
2011,9203192,5000000,6.8,4203192,Comedy
2011,9203192,5000000,6.8,4203192,Crime
2011,9203192,5000000,6.8,4203192,Drama
2011,5359774,6000000,7.3,-640226,Comedy
2011,5359774,6000000,7.3,-640226,Crime
2011,5359774,6000000,7.3,-640226,Thriller
2011,1346503,6000000,6.1,-4653497,Drama
2011,1346503,6000000,6.1,-4653497,History
2011,611709,3850000,7.2,-3238291,Comedy
2011,611709,3850000,7.2,-3238291,Drama
2011,27445,9000000,5.3,-8972555,Action
2011,27445,9000000,5.3,-8972555,Comedy
2011,27445,9000000,5.3,-8972555,Drama
2011,27445,9000000,5.3,-8972555,Thriller
2011,1196752,30300000,7.6,-29103248,Crime
2011,1196752,30300000,7.6,-29103248,Drama
2011,1196752,30300000,7.6,-29103248,Thriller
2011,104007828,5000000,5.8,99007828,Horror
2011,24809547,5000000,6.4,19809547,Comedy
2011,24809547,5000000,6.4,19809547,Drama
2011,17683670,5000000,5.2,12683670,Horror
2011,17683670,5000000,5.2,12683670,Mystery
2011,17683670,5000000,5.2,12683670,Sci-Fi
2011,17683670,5000000,5.2,12683670,Thriller
2011,1729969,5000000,7.4,-3270031,Drama
2011,1729969,5000000,7.4,-3270031,Thriller
2011,2601847,4000000,8.5,-1398153,Documentary
2011,2601847,4000000,8.5,-1398153,Music
2011,61094903,30000000,6.9,31094903,Action
2011,61094903,30000000,6.9,31094903,Mystery
2011,61094903,30000000,6.9,31094903,Thriller
2011,5354039,3500000,7.1,1854039,Biography
2011,5354039,3500000,7.1,1854039,Drama
2011,5354039,3500000,7.1,1854039,Thriller
2011,703002,3000000,6.1,-2296998,Action
2011,703002,3000000,6.1,-2296998,Comedy
2011,703002,3000000,6.1,-2296998,Thriller
2011,73678,3000000,5.9,-2926322,Drama
2011,73678,3000000,5.9,-2926322,History
2011,73678,3000000,5.9,-2926322,War
2011,22000,3000000,5.8,-2978000,Drama
2011,22000,3000000,5.8,-2978000,Sci-Fi
2011,22000,3000000,5.8,-2978000,Thriller
2011,178739,2450000,3.9,-2271261,Drama
2011,178739,2450000,3.9,-2271261,Musical
2011,12555230,2000000,5.3,10555230,Drama
2011,12555230,2000000,5.3,10555230,Horror
2011,12555230,2000000,5.3,10555230,Mystery
2011,12555230,2000000,5.3,10555230,Thriller
2011,34522221,2000000,7,32522221,Drama
2011,638476,1500000,6.6,-861524,Comedy
2011,638476,1500000,6.6,-861524,Documentary
2011,24784,1200000,7.4,-1175216,Documentary
2011,4105123,1100000,7.6,3005123,Action
2011,4105123,1100000,7.6,3005123,Crime
2011,4105123,1100000,7.6,3005123,Thriller
2011,20186,930000,5.7,-909814,Comedy
2011,7098492,500000,8.4,6598492,Drama
2011,7098492,500000,8.4,6598492,Mystery
2011,26297,500000,6.3,-473703,Crime
2011,26297,500000,6.3,-473703,Horror
2011,26297,500000,6.3,-473703,Thriller
2011,77501,750000,5.5,-672499,Horror
2011,2245,560000,7.2,-557755,Documentary
2011,906666,500000,6.8,406666,Documentary
2011,3388210,250000,6.7,3138210,Drama
2011,3388210,250000,6.7,3138210,Romance
2011,469947,120000,7.7,349947,Drama
2011,469947,120000,7.7,349947,Romance
2011,1316074,100000,7,1216074,Drama
2011,1316074,100000,7,1216074,Romance
2011,1316074,100000,7,1216074,Sci-Fi
2011,1573712,125000,6.7,1448712,Comedy
2011,1573712,125000,6.7,1448712,Drama
2011,40557,60000,5.6,-19443,Comedy
2011,4584,9000,6.4,-4416,Comedy
2011,4584,9000,6.4,-4416,Drama
2010,200807262,260000000,7.8,-59192738,Adventure
2010,200807262,260000000,7.8,-59192738,Animation
2010,200807262,260000000,7.8,-59192738,Comedy
2010,200807262,260000000,7.8,-59192738,Family
2010,200807262,260000000,7.8,-59192738,Fantasy
2010,200807262,260000000,7.8,-59192738,Musical
2010,200807262,260000000,7.8,-59192738,Romance
2010,105219735,200000000,6.7,-94780265,Action
2010,105219735,200000000,6.7,-94780265,Adventure
2010,105219735,200000000,6.7,-94780265,Drama
2010,105219735,200000000,6.7,-94780265,History
2010,334185206,200000000,6.5,134185206,Adventure
2010,334185206,200000000,6.5,134185206,Family
2010,334185206,200000000,6.5,134185206,Fantasy
2010,172051787,170000000,6.8,2051787,Action
2010,172051787,170000000,6.8,2051787,Adventure
2010,172051787,170000000,6.8,2051787,Sci-Fi
2010,414984497,200000000,8.3,214984497,Adventure
2010,414984497,200000000,8.3,214984497,Animation
2010,414984497,200000000,8.3,214984497,Comedy
2010,414984497,200000000,8.3,214984497,Family
2010,414984497,200000000,8.3,214984497,Fantasy
2010,90755643,200000000,6.6,-109244357,Action
2010,90755643,200000000,6.6,-109244357,Adventure
2010,90755643,200000000,6.6,-109244357,Fantasy
2010,90755643,200000000,6.6,-109244357,Romance
2010,312057433,200000000,7,112057433,Action
2010,312057433,200000000,7,112057433,Adventure
2010,312057433,200000000,7,112057433,Sci-Fi
2010,238371987,165000000,6.4,73371987,Adventure
2010,238371987,165000000,6.4,73371987,Animation
2010,238371987,165000000,6.4,73371987,Comedy
2010,238371987,165000000,6.4,73371987,Family
2010,238371987,165000000,6.4,73371987,Fantasy
2010,217387997,165000000,8.2,52387997,Adventure
2010,217387997,165000000,8.2,52387997,Animation
2010,217387997,165000000,8.2,52387997,Family
2010,217387997,165000000,8.2,52387997,Fantasy
2010,292568851,160000000,8.8,132568851,Action
2010,292568851,160000000,8.8,132568851,Adventure
2010,292568851,160000000,8.8,132568851,Sci-Fi
2010,292568851,160000000,8.8,132568851,Thriller
2010,63143812,150000000,6.1,-86856188,Action
2010,63143812,150000000,6.1,-86856188,Adventure
2010,63143812,150000000,6.1,-86856188,Family
2010,63143812,150000000,6.1,-86856188,Fantasy
2010,104383624,155000000,6.3,-50616376,Adventure
2010,104383624,155000000,6.3,-50616376,Family
2010,104383624,155000000,6.3,-50616376,Fantasy
2010,61937495,150000000,5.8,-88062505,Drama
2010,61937495,150000000,5.8,-88062505,Fantasy
2010,61937495,150000000,5.8,-88062505,Horror
2010,61937495,150000000,5.8,-88062505,Thriller
2010,131564731,150000000,4.2,-18435269,Action
2010,131564731,150000000,4.2,-18435269,Adventure
2010,131564731,150000000,4.2,-18435269,Family
2010,131564731,150000000,4.2,-18435269,Fantasy
2010,118311368,110000000,6.4,8311368,Action
2010,118311368,110000000,6.4,8311368,Crime
2010,118311368,110000000,6.4,8311368,Mystery
2010,118311368,110000000,6.4,8311368,Thriller
2010,148337537,130000000,7.3,18337537,Action
2010,148337537,130000000,7.3,18337537,Animation
2010,148337537,130000000,7.3,18337537,Comedy
2010,148337537,130000000,7.3,18337537,Family
2010,148337537,130000000,7.3,18337537,Sci-Fi
2010,163192114,125000000,5.8,38192114,Action
2010,163192114,125000000,5.8,38192114,Adventure
2010,163192114,125000000,5.8,38192114,Fantasy
2010,30212620,120000000,5.3,-89787380,Comedy
2010,30212620,120000000,5.3,-89787380,Drama
2010,30212620,120000000,5.3,-89787380,Romance
2010,76418654,117000000,6.3,-40581346,Action
2010,76418654,117000000,6.3,-40581346,Comedy
2010,76418654,117000000,6.3,-40581346,Romance
2010,42776259,112000000,4.9,-69223741,Adventure
2010,42776259,112000000,4.9,-69223741,Comedy
2010,42776259,112000000,4.9,-69223741,Family
2010,42776259,112000000,4.9,-69223741,Fantasy
2010,148383780,100000000,5.5,48383780,Comedy
2010,148383780,100000000,5.5,48383780,Romance
2010,119219978,100000000,6.7,19219978,Action
2010,119219978,100000000,6.7,19219978,Comedy
2010,119219978,100000000,6.7,19219978,Crime
2010,67631157,100000000,6,-32368843,Action
2010,67631157,100000000,6,-32368843,Romance
2010,67631157,100000000,6,-32368843,Thriller
2010,55673333,80000000,7,-24326667,Action
2010,55673333,80000000,7,-24326667,Adventure
2010,55673333,80000000,7,-24326667,Animation
2010,55673333,80000000,7,-24326667,Family
2010,55673333,80000000,7,-24326667,Fantasy
2010,35024475,100000000,6.9,-64975525,Action
2010,35024475,100000000,6.9,-64975525,Drama
2010,35024475,100000000,6.9,-64975525,Thriller
2010,35024475,100000000,6.9,-64975525,War
2010,95328937,100000000,4.3,-4671063,Comedy
2010,95328937,100000000,4.3,-4671063,Drama
2010,95328937,100000000,4.3,-4671063,Romance
2010,88761720,95000000,5.9,-6238280,Adventure
2010,88761720,95000000,5.9,-6238280,Family
2010,88761720,95000000,5.9,-6238280,Fantasy
2010,81557479,100000000,6.8,-18442521,Action
2010,81557479,100000000,6.8,-18442521,Thriller
2010,190562,90000000,4.4,-89809438,Action
2010,190562,90000000,4.4,-89809438,Family
2010,190562,90000000,4.4,-89809438,Fantasy
2010,190562,90000000,4.4,-89809438,Musical
2010,31494270,60000000,7.5,-28505730,Action
2010,31494270,60000000,7.5,-28505730,Comedy
2010,31494270,60000000,7.5,-28505730,Fantasy
2010,31494270,60000000,7.5,-28505730,Romance
2010,43575716,85000000,4.3,-41424284,Action
2010,43575716,85000000,4.3,-41424284,Comedy
2010,43575716,85000000,4.3,-41424284,Family
2010,43575716,85000000,4.3,-41424284,Fantasy
2010,102981571,80000000,6.5,22981571,Action
2010,102981571,80000000,6.5,22981571,Adventure
2010,102981571,80000000,6.5,22981571,Thriller
2010,127968405,80000000,8.1,47968405,Mystery
2010,127968405,80000000,8.1,47968405,Thriller
2010,94822707,80000000,6.9,14822707,Action
2010,94822707,80000000,6.9,14822707,Adventure
2010,94822707,80000000,6.9,14822707,Drama
2010,94822707,80000000,6.9,14822707,Thriller
2010,100169068,80000000,4.6,20169068,Adventure
2010,100169068,80000000,4.6,20169068,Animation
2010,100169068,80000000,4.6,20169068,Comedy
2010,100169068,80000000,4.6,20169068,Family
2010,162001186,80000000,6,82001186,Comedy
2010,47000485,75000000,5.4,-27999515,Action
2010,47000485,75000000,5.4,-27999515,Comedy
2010,47000485,75000000,5.4,-27999515,Romance
2010,47000485,75000000,5.4,-27999515,Thriller
2010,52474616,70000000,6.3,-17525384,Drama
2010,300523113,68000000,4.9,232523113,Adventure
2010,300523113,68000000,4.9,232523113,Drama
2010,300523113,68000000,4.9,232523113,Fantasy
2010,300523113,68000000,4.9,232523113,Romance
2010,251501645,69000000,7.7,182501645,Animation
2010,251501645,69000000,7.7,182501645,Comedy
2010,251501645,69000000,7.7,182501645,Family
2010,100448498,65000000,6.6,35448498,Comedy
2010,100448498,65000000,6.6,35448498,Drama
2010,80574010,60000000,5.7,20574010,Drama
2010,80574010,60000000,5.7,20574010,Romance
2010,90356857,58000000,7.1,32356857,Action
2010,90356857,58000000,7.1,32356857,Comedy
2010,90356857,58000000,7.1,32356857,Crime
2010,90356857,58000000,7.1,32356857,Thriller
2010,43290977,80000000,6.6,-36709023,Crime
2010,43290977,80000000,6.6,-36709023,Drama
2010,43290977,80000000,6.6,-36709023,Mystery
2010,43290977,80000000,6.6,-36709023,Thriller
2010,60128566,60000000,5.9,128566,Action
2010,60128566,60000000,5.9,128566,Adventure
2010,60128566,60000000,5.9,128566,Horror
2010,60128566,60000000,5.9,128566,Sci-Fi
2010,98711404,55000000,6.3,43711404,Comedy
2010,98711404,55000000,6.3,43711404,Crime
2010,98711404,55000000,6.3,43711404,Romance
2010,98711404,55000000,6.3,43711404,Thriller
2010,39440655,55000000,6.4,-15559345,Drama
2010,39440655,55000000,6.4,-15559345,Music
2010,39440655,55000000,6.4,-15559345,Musical
2010,39440655,55000000,6.4,-15559345,Romance
2010,110476776,52000000,5.7,58476776,Comedy
2010,110476776,52000000,5.7,58476776,Romance
2010,23324666,52000000,6.5,-28675334,Action
2010,23324666,52000000,6.5,-28675334,Thriller
2010,33643461,50000000,4.2,-16356539,Comedy
2010,33643461,50000000,4.2,-16356539,Family
2010,32741596,50000000,6.5,-17258404,Drama
2010,32741596,50000000,6.5,-17258404,Fantasy
2010,9528092,22000000,6.8,-12471908,Biography
2010,9528092,22000000,6.8,-12471908,Drama
2010,9528092,22000000,6.8,-12471908,Thriller
2010,10539414,47000000,4.7,-36460586,Action
2010,10539414,47000000,4.7,-36460586,Drama
2010,10539414,47000000,4.7,-36460586,Fantasy
2010,10539414,47000000,4.7,-36460586,Thriller
2010,10539414,47000000,4.7,-36460586,Western
2010,15523168,45000000,7.2,-29476832,Mystery
2010,15523168,45000000,7.2,-29476832,Thriller
2010,67061228,40000000,5.5,27061228,Action
2010,67061228,40000000,5.5,27061228,Comedy
2010,67061228,40000000,5.5,27061228,Romance
2010,31136950,44000000,6.5,-12863050,Drama
2010,31136950,44000000,6.5,-12863050,Fantasy
2010,31136950,44000000,6.5,-12863050,Romance
2010,5664251,45000000,6.3,-39335749,Action
2010,5664251,45000000,6.3,-39335749,Fantasy
2010,5664251,45000000,6.3,-39335749,Western
2010,96917897,40000000,7.7,56917897,Biography
2010,96917897,40000000,7.7,56917897,Drama
2010,52000688,40000000,6.4,12000688,Action
2010,52000688,40000000,6.4,12000688,Adventure
2010,52000688,40000000,6.4,12000688,Sci-Fi
2010,52000688,40000000,6.4,12000688,Thriller
2010,30993544,40000000,6.5,-9006456,Comedy
2010,30993544,40000000,6.5,-9006456,Drama
2010,30993544,40000000,6.5,-9006456,Romance
2010,92173235,37000000,7.6,55173235,Crime
2010,92173235,37000000,7.6,55173235,Drama
2010,92173235,37000000,7.6,55173235,Thriller
2010,44867349,37000000,5.6,7867349,Action
2010,44867349,37000000,5.6,7867349,Comedy
2010,44867349,37000000,5.6,7867349,Crime
2010,50213619,36000000,6.4,14213619,Comedy
2010,50213619,36000000,6.4,14213619,Sci-Fi
2010,171031347,38000000,7.7,133031347,Adventure
2010,171031347,38000000,7.7,133031347,Drama
2010,171031347,38000000,7.7,133031347,Western
2010,59699513,35000000,7.2,24699513,Biography
2010,59699513,35000000,7.2,24699513,Drama
2010,59699513,35000000,7.2,24699513,Family
2010,59699513,35000000,7.2,24699513,History
2010,59699513,35000000,7.2,24699513,Sport
2010,37481242,35000000,5.3,2481242,Comedy
2010,37481242,35000000,5.3,2481242,Romance
2010,28995450,35000000,6.1,-6004550,Comedy
2010,28995450,35000000,6.1,-6004550,Family
2010,28995450,35000000,6.1,-6004550,Fantasy
2010,17596256,35000000,3.8,-17403744,Comedy
2010,17596256,35000000,3.8,-17403744,Family
2010,57744720,20000000,6.2,37744720,Action
2010,57744720,20000000,6.2,37744720,Crime
2010,57744720,20000000,6.2,37744720,Thriller
2010,13763130,32000000,6.3,-18236870,Action
2010,13763130,32000000,6.3,-18236870,Crime
2010,13763130,32000000,6.3,-18236870,Sci-Fi
2010,13763130,32000000,6.3,-18236870,Thriller
2010,17797316,32000000,6.3,-14202684,Comedy
2010,17797316,32000000,6.3,-14202684,Romance
2010,11854694,31000000,6.5,-19145306,Drama
2010,53021560,30000000,6.5,23021560,Comedy
2010,53021560,30000000,6.5,23021560,Drama
2010,53021560,30000000,6.5,23021560,Romance
2010,42385520,30000000,6.2,12385520,Drama
2010,42385520,30000000,6.2,12385520,Music
2010,42385520,30000000,6.2,12385520,Romance
2010,21129348,35000000,7.4,-13870652,Crime
2010,21129348,35000000,7.4,-13870652,Drama
2010,21129348,35000000,7.4,-13870652,Romance
2010,21129348,35000000,7.4,-13870652,Thriller
2010,32357532,30000000,6.7,2357532,Comedy
2010,32357532,30000000,6.7,2357532,Drama
2010,32357532,30000000,6.7,2357532,Romance
2010,48043505,30000000,7.7,18043505,Action
2010,48043505,30000000,7.7,18043505,Comedy
2010,24268828,28000000,5.4,-3731172,Action
2010,24268828,28000000,5.4,-3731172,Comedy
2010,24268828,28000000,5.4,-3731172,Family
2010,40168080,26000000,5.2,14168080,Action
2010,40168080,26000000,5.2,14168080,Fantasy
2010,40168080,26000000,5.2,14168080,Horror
2010,80014842,25000000,6.3,55014842,Drama
2010,80014842,25000000,6.3,55014842,Romance
2010,80014842,25000000,6.3,55014842,War
2010,23527955,25000000,6.4,-1472045,Action
2010,23527955,25000000,6.4,-1472045,Crime
2010,23527955,25000000,6.4,-1472045,Drama
2010,23527955,25000000,6.4,-1472045,Mystery
2010,23527955,25000000,6.4,-1472045,Thriller
2010,24042490,25000000,5.6,-957510,Fantasy
2010,24042490,25000000,5.6,-957510,Horror
2010,24042490,25000000,5.6,-957510,Thriller
2010,14637490,25000000,4.8,-10362510,Horror
2010,14637490,25000000,4.8,-10362510,Mystery
2010,14637490,25000000,4.8,-10362510,Thriller
2010,11538204,25000000,7,-13461796,Crime
2010,11538204,25000000,7,-13461796,Drama
2010,11538204,25000000,7,-13461796,History
2010,183662,25000000,7.1,-24816338,Comedy
2010,183662,25000000,7.1,-24816338,Drama
2010,134904,25000000,5.7,-24865096,Comedy
2010,134904,25000000,5.7,-24865096,Drama
2010,134904,25000000,5.7,-24865096,Romance
2010,134904,25000000,5.7,-24865096,Sport
2010,25003072,24000000,5.5,1003072,Comedy
2010,25003072,24000000,5.5,1003072,Horror
2010,23225911,24000000,6.5,-774089,Action
2010,23225911,24000000,6.5,-774089,Crime
2010,23225911,24000000,6.5,-774089,Drama
2010,23225911,24000000,6.5,-774089,Thriller
2010,1796024,22000000,5.4,-20203976,Drama
2010,1796024,22000000,5.4,-20203976,Thriller
2010,117224271,20000000,7.1,97224271,Action
2010,117224271,20000000,7.1,97224271,Comedy
2010,117224271,20000000,7.1,97224271,Documentary
2010,62933793,20000000,5.8,42933793,Drama
2010,62933793,20000000,5.8,42933793,Family
2010,62933793,20000000,5.8,42933793,Music
2010,62933793,20000000,5.8,42933793,Romance
2010,60072596,20000000,4.4,40072596,Comedy
2010,60072596,20000000,4.4,40072596,Drama
2010,60072596,20000000,4.4,40072596,Romance
2010,35596227,20000000,6.3,15596227,Crime
2010,35596227,20000000,6.3,15596227,Drama
2010,35596227,20000000,6.3,15596227,Thriller
2010,36658108,20000000,3.5,16658108,Comedy
2010,31146570,20000000,6.9,11146570,Drama
2010,31146570,20000000,6.9,11146570,Thriller
2010,25677801,20000000,5.8,5677801,Comedy
2010,25677801,20000000,5.8,5677801,Family
2010,25677801,20000000,5.8,5677801,Romance
2010,31584722,20000000,6.4,11584722,Comedy
2010,31584722,20000000,6.4,11584722,Romance
2010,25077977,20000000,5.3,5077977,Adventure
2010,25077977,20000000,5.3,5077977,Animation
2010,25077977,20000000,5.3,5077977,Comedy
2010,25077977,20000000,5.3,5077977,Family
2010,25077977,20000000,5.3,5077977,Romance
2010,12134420,20000000,7.2,-7865580,Drama
2010,12134420,20000000,7.2,-7865580,Fantasy
2010,12134420,20000000,7.2,-7865580,Horror
2010,12134420,20000000,7.2,-7865580,Mystery
2010,1183354,20000000,5.1,-18816646,Action
2010,1183354,20000000,5.1,-18816646,Comedy
2010,1183354,20000000,5.1,-18816646,Crime
2010,1183354,20000000,5.1,-18816646,Fantasy
2010,1183354,20000000,5.1,-18816646,Horror
2010,1183354,20000000,5.1,-18816646,Mystery
2010,1183354,20000000,5.1,-18816646,Sci-Fi
2010,1183354,20000000,5.1,-18816646,Thriller
2010,263365,20000000,5.4,-19736635,Comedy
2010,263365,20000000,5.4,-19736635,Drama
2010,263365,20000000,5.4,-19736635,Fantasy
2010,263365,20000000,5.4,-19736635,Romance
2010,27758465,19000000,6.1,8758465,Comedy
2010,27758465,19000000,6.1,8758465,Drama
2010,27758465,19000000,6.1,8758465,Romance
2010,39103378,20000000,6.5,19103378,Horror
2010,39103378,20000000,6.5,19103378,Thriller
2010,12561,19000000,6.4,-18987439,Comedy
2010,12561,19000000,6.4,-18987439,Romance
2010,18329466,18000000,7.6,329466,Adventure
2010,18329466,18000000,7.6,329466,Biography
2010,18329466,18000000,7.6,329466,Drama
2010,18329466,18000000,7.6,329466,Thriller
2010,45670855,20000000,5.6,25670855,Horror
2010,45670855,20000000,5.6,25670855,Mystery
2010,172051787,170000000,6.8,2051787,Action
2010,172051787,170000000,6.8,2051787,Adventure
2010,172051787,170000000,6.8,2051787,Sci-Fi
2010,19057024,16000000,7.2,3057024,Drama
2010,19057024,16000000,7.2,3057024,Romance
2010,138795342,15000000,8,123795342,Biography
2010,138795342,15000000,8,123795342,Drama
2010,138795342,15000000,8,123795342,History
2010,138795342,15000000,8,123795342,Romance
2010,64001297,15000000,6.2,49001297,Comedy
2010,64001297,15000000,6.2,49001297,Family
2010,163192114,125000000,5.8,38192114,Action
2010,163192114,125000000,5.8,38192114,Adventure
2010,163192114,125000000,5.8,38192114,Fantasy
2010,26161406,15000000,6.7,11161406,Adventure
2010,26161406,15000000,6.7,11161406,Comedy
2010,26161406,15000000,6.7,11161406,Family
2010,26161406,15000000,6.7,11161406,Fantasy
2010,20218921,15000000,6.3,5218921,Drama
2010,20218921,15000000,6.3,5218921,Music
2010,3247816,22000000,6.3,-18752184,Comedy
2010,3247816,22000000,6.3,-18752184,Drama
2010,3247816,22000000,6.3,-18752184,Romance
2010,2412045,15000000,7.2,-12587955,Drama
2010,2412045,15000000,7.2,-12587955,Romance
2010,2412045,15000000,7.2,-12587955,Sci-Fi
2010,7691700,10000000,7.5,-2308300,Drama
2010,7691700,10000000,7.5,-2308300,War
2010,20246959,14000000,4.9,6246959,Comedy
2010,20246959,14000000,4.9,6246959,Romance
2010,1752214,14000000,7.7,-12247786,Comedy
2010,1752214,14000000,7.7,-12247786,Drama
2010,1752214,14000000,7.7,-12247786,Romance
2010,163591,13400000,3.6,-13236409,Comedy
2010,106952327,13000000,8,93952327,Drama
2010,106952327,13000000,8,93952327,Thriller
2010,214966,13000000,6.1,-12785034,Crime
2010,214966,13000000,6.1,-12785034,Drama
2010,214966,13000000,6.1,-12785034,Thriller
2010,26589953,10500000,6.7,16089953,Action
2010,26589953,10500000,6.7,16089953,Crime
2010,26589953,10500000,6.7,16089953,Thriller
2010,1039869,15000000,6.2,-13960131,Biography
2010,1039869,15000000,6.2,-13960131,Comedy
2010,1039869,15000000,6.2,-13960131,Crime
2010,1039869,15000000,6.2,-13960131,Drama
2010,93571803,25000000,7.9,68571803,Biography
2010,93571803,25000000,7.9,68571803,Drama
2010,93571803,25000000,7.9,68571803,Sport
2010,33583175,10000000,6.3,23583175,Horror
2010,33583175,10000000,6.3,23583175,Mystery
2010,33583175,10000000,6.3,23583175,Thriller
2010,21371425,10000000,4.4,11371425,Action
2010,21371425,10000000,4.4,11371425,Sci-Fi
2010,21371425,10000000,4.4,11371425,Thriller
2010,8460995,10000000,5.5,-1539005,Action
2010,8460995,10000000,5.5,-1539005,Comedy
2010,8460995,10000000,5.5,-1539005,Romance
2010,67631157,100000000,6,-32368843,Action
2010,67631157,100000000,6,-32368843,Romance
2010,67631157,100000000,6,-32368843,Thriller
2010,1602466,600000000,6,-598397534,Action
2010,1602466,600000000,6,-598397534,Drama
2010,1602466,600000000,6,-598397534,Romance
2010,1602466,600000000,6,-598397534,Thriller
2010,3571735,10000000,6.6,-6428265,Biography
2010,3571735,10000000,6.6,-6428265,Drama
2010,3571735,10000000,6.6,-6428265,Music
2010,4018695,12000000,8,-7981305,Adventure
2010,4018695,12000000,8,-7981305,Drama
2010,4018695,12000000,8,-7981305,Thriller
2010,58401464,8000000,7.1,50401464,Comedy
2010,58401464,8000000,7.1,50401464,Romance
2010,3205244,10000000,7.3,-6794756,Comedy
2010,3205244,10000000,7.3,-6794756,Drama
2010,6350058,8000000,7.2,-1649942,Comedy
2010,6350058,8000000,7.2,-1649942,Drama
2010,6350058,8000000,7.2,-1649942,Romance
2010,1094798,7200000,7.2,-6105202,Biography
2010,1094798,7200000,7.2,-6105202,Comedy
2010,1094798,7200000,7.2,-6105202,Drama
2010,1094798,7200000,7.2,-6105202,History
2010,117190,8000000,6.9,-7882810,Action
2010,117190,8000000,6.9,-7882810,Comedy
2010,117190,8000000,6.9,-7882810,Crime
2010,7455447,7000000,6.3,455447,Comedy
2010,7455447,7000000,6.3,455447,Drama
2010,7455447,7000000,6.3,455447,Romance
2010,1768416,7000000,6.3,-5231584,Comedy
2010,1768416,7000000,6.3,-5231584,Drama
2010,382946,7000000,7.1,-6617054,Drama
2010,453079,7000000,5.9,-6546921,Comedy
2010,46451,7000000,6,-6953549,Comedy
2010,46451,7000000,6,-6953549,Crime
2010,46451,7000000,6,-6953549,Thriller
2010,6857096,6800000,8.2,57096,Drama
2010,6857096,6800000,8.2,57096,Mystery
2010,6857096,6800000,8.2,57096,War
2010,399611,6000000,5.7,-5600389,Biography
2010,399611,6000000,5.7,-5600389,Drama
2010,399611,6000000,5.7,-5600389,Sport
2010,4074023,5000000,6.9,-925977,Documentary
2010,3950029,4000000,7.2,-49971,Drama
2010,2711210,5000000,6.4,-2288790,Comedy
2010,2711210,5000000,6.4,-2288790,Drama
2010,2221809,5000000,7,-2778191,Drama
2010,513836,4600000,7.2,-4086164,Comedy
2010,513836,4600000,7.2,-4086164,Drama
2010,513836,4600000,7.2,-4086164,Romance
2010,20803237,3500000,7.1,17303237,Comedy
2010,20803237,3500000,7.1,17303237,Drama
2010,14637490,25000000,4.8,-10362510,Horror
2010,14637490,25000000,4.8,-10362510,Mystery
2010,14637490,25000000,4.8,-10362510,Thriller
2010,58214,9500000,7,-9441786,Crime
2010,58214,9500000,7,-9441786,Drama
2010,58214,9500000,7,-9441786,Thriller
2010,18469,650000,6.5,-631531,Drama
2010,18469,650000,6.5,-631531,Horror
2010,18469,650000,6.5,-631531,Sci-Fi
2010,252652,19900000,7,-19647348,Comedy
2010,252652,19900000,7,-19647348,Drama
2010,252652,19900000,7,-19647348,Fantasy
2010,252652,19900000,7,-19647348,Horror
2010,5776314,3200000,7.2,2576314,Comedy
2010,5776314,3200000,7.2,2576314,Drama
2010,5776314,3200000,7.2,2576314,Romance
2010,84749884,3000000,5.7,81749884,Horror
2010,2848578,3500000,6.3,-651422,Drama
2010,2848578,3500000,6.3,-651422,Family
2010,334185206,200000000,6.5,134185206,Adventure
2010,334185206,200000000,6.5,134185206,Family
2010,334185206,200000000,6.5,134185206,Fantasy
2010,100675,3000000,6.4,-2899325,Documentary
2010,99851,2500000,7.1,-2400149,Documentary
2010,322157,2500000,6.8,-2177843,Comedy
2010,322157,2500000,6.8,-2177843,Crime
2010,322157,2500000,6.8,-2177843,Drama
2010,6531491,2000000,7.2,4531491,Drama
2010,535249,3400000,4.6,-2864751,Comedy
2010,1028658,3000000,7,-1971342,Drama
2010,1028658,3000000,7,-1971342,Mystery
2010,1028658,3000000,7,-1971342,Thriller
2010,40990055,1800000,5.6,39190055,Drama
2010,40990055,1800000,5.6,39190055,Horror
2010,40990055,1800000,5.6,39190055,Thriller
2010,92401,2000000,6.3,-1907599,Horror
2010,92401,2000000,6.3,-1907599,Thriller
2010,53991137,1500000,6.8,52491137,Fantasy
2010,53991137,1500000,6.8,52491137,Horror
2010,53991137,1500000,6.8,52491137,Mystery
2010,53991137,1500000,6.8,52491137,Thriller
2010,183490,1700000,5.8,-1516510,Drama
2010,183490,1700000,5.8,-1516510,War
2010,56129,1100000,6.1,-1043871,Sci-Fi
2010,56129,1100000,6.1,-1043871,Thriller
2010,9701559,3500000,7.4,6201559,Drama
2010,9701559,3500000,7.4,6201559,Romance
2010,48430,500000,6.8,-451570,Comedy
2010,48430,500000,6.8,-451570,Crime
2010,48430,500000,6.8,-451570,Thriller
2010,98017,500000,5.8,-401983,Comedy
2010,98017,500000,5.8,-401983,Fantasy
2010,98017,500000,5.8,-401983,Horror
2010,237301,500000,6.4,-262699,Drama
2010,237301,500000,6.4,-262699,Sci-Fi
2010,237301,500000,6.4,-262699,Thriller
2010,425899,400000,5.1,25899,Documentary
2010,2428241,200000,6.4,2228241,Drama
2010,389804,65000,6.3,324804,Comedy
2010,389804,65000,6.3,324804,Drama
2010,389804,65000,6.3,324804,Romance
2009,760505847,237000000,7.9,523505847,Action
2009,760505847,237000000,7.9,523505847,Adventure
2009,760505847,237000000,7.9,523505847,Fantasy
2009,760505847,237000000,7.9,523505847,Sci-Fi
2009,301956980,250000000,7.5,51956980,Adventure
2009,301956980,250000000,7.5,51956980,Family
2009,301956980,250000000,7.5,51956980,Fantasy
2009,301956980,250000000,7.5,51956980,Mystery
2009,402076689,200000000,6,202076689,Action
2009,402076689,200000000,6,202076689,Adventure
2009,402076689,200000000,6,202076689,Sci-Fi
2009,125320003,200000000,6.6,-74679997,Action
2009,125320003,200000000,6.6,-74679997,Adventure
2009,125320003,200000000,6.6,-74679997,Sci-Fi
2009,166112167,200000000,5.8,-33887833,Action
2009,166112167,200000000,5.8,-33887833,Adventure
2009,166112167,200000000,5.8,-33887833,Sci-Fi
2009,137850096,200000000,6.8,-62149904,Animation
2009,137850096,200000000,6.8,-62149904,Drama
2009,137850096,200000000,6.8,-62149904,Family
2009,137850096,200000000,6.8,-62149904,Fantasy
2009,292979556,175000000,8.3,117979556,Adventure
2009,292979556,175000000,8.3,117979556,Animation
2009,292979556,175000000,8.3,117979556,Comedy
2009,292979556,175000000,8.3,117979556,Family
2009,198332128,175000000,6.5,23332128,Action
2009,198332128,175000000,6.5,23332128,Adventure
2009,198332128,175000000,6.5,23332128,Animation
2009,198332128,175000000,6.5,23332128,Comedy
2009,198332128,175000000,6.5,23332128,Family
2009,198332128,175000000,6.5,23332128,Sci-Fi
2009,150167630,175000000,5.8,-24832370,Action
2009,150167630,175000000,5.8,-24832370,Adventure
2009,150167630,175000000,5.8,-24832370,Sci-Fi
2009,150167630,175000000,5.8,-24832370,Thriller
2009,177243721,150000000,5.9,27243721,Adventure
2009,177243721,150000000,5.9,27243721,Comedy
2009,177243721,150000000,5.9,27243721,Family
2009,177243721,150000000,5.9,27243721,Fantasy
2009,179883016,150000000,6.7,29883016,Action
2009,179883016,150000000,6.7,29883016,Adventure
2009,179883016,150000000,6.7,29883016,Fantasy
2009,179883016,150000000,6.7,29883016,Sci-Fi
2009,179883016,150000000,6.7,29883016,Thriller
2009,133375846,150000000,6.7,-16624154,Mystery
2009,133375846,150000000,6.7,-16624154,Thriller
2009,119420252,150000000,5.1,-30579748,Action
2009,119420252,150000000,5.1,-30579748,Adventure
2009,119420252,150000000,5.1,-30579748,Animation
2009,119420252,150000000,5.1,-30579748,Comedy
2009,119420252,150000000,5.1,-30579748,Family
2009,119420252,150000000,5.1,-30579748,Fantasy
2009,119420252,150000000,5.1,-30579748,Sci-Fi
2009,257704099,150000000,8,107704099,Action
2009,257704099,150000000,8,107704099,Adventure
2009,257704099,150000000,8,107704099,Sci-Fi
2009,107503316,130000000,7.7,-22496684,Action
2009,107503316,130000000,7.7,-22496684,Drama
2009,107503316,130000000,7.7,-22496684,Mystery
2009,107503316,130000000,7.7,-22496684,Sci-Fi
2009,104374107,105000000,7.1,-625893,Animation
2009,104374107,105000000,7.1,-625893,Family
2009,104374107,105000000,7.1,-625893,Fantasy
2009,104374107,105000000,7.1,-625893,Musical
2009,104374107,105000000,7.1,-625893,Romance
2009,97030725,100000000,7,-2969275,Biography
2009,97030725,100000000,7,-2969275,Crime
2009,97030725,100000000,7,-2969275,Drama
2009,97030725,100000000,7,-2969275,History
2009,97030725,100000000,7,-2969275,Romance
2009,65452312,100000000,6.4,-34547688,Action
2009,65452312,100000000,6.4,-34547688,Crime
2009,65452312,100000000,6.4,-34547688,Thriller
2009,77222184,100000000,6.8,-22777816,Adventure
2009,77222184,100000000,6.8,-22777816,Drama
2009,77222184,100000000,6.8,-22777816,Family
2009,77222184,100000000,6.8,-22777816,Fantasy
2009,49392095,100000000,5.4,-50607905,Adventure
2009,49392095,100000000,5.4,-50607905,Comedy
2009,49392095,100000000,5.4,-50607905,Sci-Fi
2009,43982842,65000000,6.7,-21017158,Drama
2009,43982842,65000000,6.7,-21017158,Fantasy
2009,43982842,65000000,6.7,-21017158,Thriller
2009,124870275,100000000,7,24870275,Animation
2009,124870275,100000000,7,24870275,Comedy
2009,124870275,100000000,7,24870275,Family
2009,124870275,100000000,7,24870275,Sci-Fi
2009,196573705,90000000,7,106573705,Action
2009,196573705,90000000,7,106573705,Adventure
2009,196573705,90000000,7,106573705,Animation
2009,196573705,90000000,7,106573705,Comedy
2009,196573705,90000000,7,106573705,Family
2009,209019489,90000000,7.6,119019489,Action
2009,209019489,90000000,7.6,119019489,Adventure
2009,209019489,90000000,7.6,119019489,Crime
2009,209019489,90000000,7.6,119019489,Mystery
2009,209019489,90000000,7.6,119019489,Thriller
2009,112703470,85000000,6.6,27703470,Comedy
2009,112703470,85000000,6.6,27703470,Drama
2009,112703470,85000000,6.6,27703470,Romance
2009,38542418,80000000,6.3,-41457582,Action
2009,38542418,80000000,6.3,-41457582,Sci-Fi
2009,38542418,80000000,6.3,-41457582,Thriller
2009,19673424,80000000,5.8,-60326576,Drama
2009,19673424,80000000,5.8,-60326576,Musical
2009,19673424,80000000,5.8,-60326576,Romance
2009,19406406,40000000,7.8,-20593594,Documentary
2009,19406406,40000000,7.8,-20593594,Drama
2009,73023275,35000000,5.4,38023275,Comedy
2009,73023275,35000000,5.4,38023275,Family
2009,51814190,75000000,6.4,-23185810,Comedy
2009,51814190,75000000,6.4,-23185810,Drama
2009,120523073,75000000,8.3,45523073,Adventure
2009,120523073,75000000,8.3,45523073,Drama
2009,120523073,75000000,8.3,45523073,War
2009,219613391,75000000,4.5,144613391,Animation
2009,219613391,75000000,4.5,144613391,Comedy
2009,219613391,75000000,4.5,144613391,Family
2009,219613391,75000000,4.5,144613391,Fantasy
2009,219613391,75000000,4.5,144613391,Music
2009,617840,70000000,7.2,-69382160,Adventure
2009,617840,70000000,7.2,-69382160,Drama
2009,617840,70000000,7.2,-69382160,History
2009,617840,70000000,7.2,-69382160,Romance
2009,19548064,65000000,6.3,-45451936,Action
2009,19548064,65000000,6.3,-45451936,Animation
2009,19548064,65000000,6.3,-45451936,Comedy
2009,19548064,65000000,6.3,-45451936,Family
2009,19548064,65000000,6.3,-45451936,Sci-Fi
2009,109176215,60000000,5.5,49176215,Comedy
2009,71844424,60000000,7.3,11844424,Documentary
2009,71844424,60000000,7.3,11844424,Music
2009,75280058,60000000,7.7,15280058,Animation
2009,75280058,60000000,7.7,15280058,Family
2009,75280058,60000000,7.7,15280058,Fantasy
2009,43337279,60000000,4.9,-16662721,Adventure
2009,43337279,60000000,4.9,-16662721,Comedy
2009,37479778,60000000,7.4,-22520222,Biography
2009,37479778,60000000,7.4,-22520222,Drama
2009,37479778,60000000,7.4,-22520222,History
2009,37479778,60000000,7.4,-22520222,Sport
2009,40559930,60000000,6.2,-19440070,Comedy
2009,40559930,60000000,6.2,-19440070,Crime
2009,40559930,60000000,6.2,-19440070,Romance
2009,40559930,60000000,6.2,-19440070,Thriller
2009,42194060,70000000,6.1,-27805940,Adventure
2009,42194060,70000000,6.1,-27805940,Animation
2009,42194060,70000000,6.1,-27805940,Comedy
2009,42194060,70000000,6.1,-27805940,Family
2009,42194060,70000000,6.1,-27805940,Sci-Fi
2009,31670931,60000000,6.7,-28329069,Biography
2009,31670931,60000000,6.7,-28329069,Drama
2009,31670931,60000000,6.7,-28329069,Music
2009,29580087,58000000,4.7,-28419913,Comedy
2009,29580087,58000000,4.7,-28419913,Drama
2009,29580087,58000000,4.7,-28419913,Romance
2009,16088610,55000000,5.6,-38911390,Comedy
2009,16088610,55000000,5.6,-38911390,Drama
2009,16088610,55000000,5.6,-38911390,Family
2009,16088610,55000000,5.6,-38911390,Fantasy
2009,73343413,50000000,7.4,23343413,Crime
2009,73343413,50000000,7.4,23343413,Drama
2009,73343413,50000000,7.4,23343413,Thriller
2009,296623634,50000000,4.6,246623634,Adventure
2009,296623634,50000000,4.6,246623634,Drama
2009,296623634,50000000,4.6,246623634,Fantasy
2009,296623634,50000000,4.6,246623634,Romance
2009,79948113,50000000,6.2,29948113,Drama
2009,79948113,50000000,6.2,29948113,Mystery
2009,79948113,50000000,6.2,29948113,Sci-Fi
2009,79948113,50000000,6.2,29948113,Thriller
2009,67128202,65000000,5.7,2128202,Action
2009,67128202,65000000,5.7,2128202,Adventure
2009,67128202,65000000,5.7,2128202,Family
2009,67128202,65000000,5.7,2128202,Fantasy
2009,67128202,65000000,5.7,2128202,Sci-Fi
2009,67128202,65000000,5.7,2128202,Thriller
2009,38105077,40000000,6.4,-1894923,Action
2009,38105077,40000000,6.4,-1894923,Crime
2009,38105077,40000000,6.4,-1894923,Thriller
2009,25450527,50000000,6.5,-24549473,Action
2009,25450527,50000000,6.5,-24549473,Crime
2009,25450527,50000000,6.5,-24549473,Drama
2009,25450527,50000000,6.5,-24549473,Mystery
2009,25450527,50000000,6.5,-24549473,Thriller
2009,20488579,50000000,5.8,-29511421,Action
2009,20488579,50000000,5.8,-29511421,Sci-Fi
2009,20488579,50000000,5.8,-29511421,Thriller
2009,8742261,18000000,3.7,-9257739,Action
2009,8742261,18000000,3.7,-9257739,Crime
2009,8742261,18000000,3.7,-9257739,Drama
2009,8742261,18000000,3.7,-9257739,Mystery
2009,8742261,18000000,3.7,-9257739,Thriller
2009,25200412,45000000,5.4,-19799588,Adventure
2009,25200412,45000000,5.4,-19799588,Comedy
2009,25200412,45000000,5.4,-19799588,Family
2009,25200412,45000000,5.4,-19799588,Fantasy
2009,25200412,45000000,5.4,-19799588,Sci-Fi
2009,59992760,42000000,5.8,17992760,Comedy
2009,1260917,27000000,7.2,-25739083,Action
2009,1260917,27000000,7.2,-25739083,Comedy
2009,1260917,27000000,7.2,-25739083,Crime
2009,163947053,40000000,6.7,123947053,Comedy
2009,163947053,40000000,6.7,123947053,Drama
2009,163947053,40000000,6.7,123947053,Romance
2009,93952276,40000000,6.4,53952276,Comedy
2009,93952276,40000000,6.4,53952276,Drama
2009,93952276,40000000,6.4,53952276,Romance
2009,94125426,40000000,7,54125426,Biography
2009,94125426,40000000,7,54125426,Drama
2009,94125426,40000000,7,54125426,Romance
2009,71347010,40000000,7.1,31347010,Comedy
2009,71347010,40000000,7.1,31347010,Romance
2009,64149837,20000000,6.4,44149837,Comedy
2009,64149837,20000000,6.4,44149837,Drama
2009,64149837,20000000,6.4,44149837,Family
2009,64149837,20000000,6.4,44149837,Fantasy
2009,64149837,20000000,6.4,44149837,Romance
2009,66466372,40000000,5.2,26466372,Horror
2009,20999103,40000000,7.8,-19000897,Adventure
2009,20999103,40000000,7.8,-19000897,Animation
2009,20999103,40000000,7.8,-19000897,Comedy
2009,20999103,40000000,7.8,-19000897,Crime
2009,20999103,40000000,7.8,-19000897,Family
2009,13838130,40000000,5.9,-26161870,Action
2009,13838130,40000000,5.9,-26161870,Adventure
2009,13838130,40000000,5.9,-26161870,Fantasy
2009,13838130,40000000,5.9,-26161870,Thriller
2009,10326062,33000000,6.8,-22673938,Action
2009,10326062,33000000,6.8,-22673938,Horror
2009,10326062,33000000,6.8,-22673938,Mystery
2009,10326062,33000000,6.8,-22673938,Sci-Fi
2009,10326062,33000000,6.8,-22673938,Thriller
2009,63411478,39000000,7.1,24411478,Drama
2009,63411478,39000000,7.1,24411478,Fantasy
2009,63411478,39000000,7.1,24411478,Romance
2009,63411478,39000000,7.1,24411478,Sci-Fi
2009,88915214,38000000,6.5,50915214,Comedy
2009,88915214,38000000,6.5,50915214,Romance
2009,47536959,10000000,7.3,37536959,Drama
2009,277313371,35000000,7.8,242313371,Comedy
2009,255950375,29000000,7.7,226950375,Biography
2009,255950375,29000000,7.7,226950375,Drama
2009,255950375,29000000,7.7,226950375,Sport
2009,49474048,35000000,5.4,14474048,Comedy
2009,49474048,35000000,5.4,14474048,Family
2009,45802315,35000000,6.6,10802315,Action
2009,45802315,35000000,6.6,10802315,Adventure
2009,45802315,35000000,6.6,10802315,Fantasy
2009,45802315,35000000,6.6,10802315,Sci-Fi
2009,45802315,35000000,6.6,10802315,Thriller
2009,10991381,35000000,7.3,-24008619,Biography
2009,10991381,35000000,7.3,-24008619,Drama
2009,10991381,35000000,7.3,-24008619,History
2009,10991381,35000000,7.3,-24008619,Romance
2009,10268846,35000000,5.5,-24731154,Action
2009,10268846,35000000,5.5,-24731154,Crime
2009,10268846,35000000,5.5,-24731154,Mystery
2009,10268846,35000000,5.5,-24731154,Thriller
2009,115646235,30000000,8,85646235,Action
2009,115646235,30000000,8,85646235,Sci-Fi
2009,115646235,30000000,8,85646235,Thriller
2009,79566871,30000000,4.2,49566871,Comedy
2009,79566871,30000000,4.2,49566871,Drama
2009,79566871,30000000,4.2,49566871,Family
2009,79566871,30000000,4.2,49566871,Music
2009,79566871,30000000,4.2,49566871,Romance
2009,83813460,25000000,7.4,58813460,Drama
2009,83813460,25000000,7.4,58813460,Romance
2009,58715510,30000000,5.4,28715510,Comedy
2009,58715510,30000000,5.4,28715510,Romance
2009,42057340,30000000,6.6,12057340,Horror
2009,42057340,30000000,6.6,12057340,Thriller
2009,31743332,30000000,7.1,1743332,Action
2009,31743332,30000000,7.1,1743332,Adventure
2009,31743332,30000000,7.1,1743332,Animation
2009,31743332,30000000,7.1,1743332,Drama
2009,31743332,30000000,7.1,1743332,Mystery
2009,31743332,30000000,7.1,1743332,Sci-Fi
2009,31743332,30000000,7.1,1743332,Thriller
2009,16999046,26000000,5.8,-9000954,Drama
2009,16999046,26000000,5.8,-9000954,Horror
2009,16999046,26000000,5.8,-9000954,Sci-Fi
2009,9353573,45000000,2.7,-35646427,Action
2009,9353573,45000000,2.7,-35646427,Adventure
2009,9353573,45000000,2.7,-35646427,Fantasy
2009,9353573,45000000,2.7,-35646427,Sci-Fi
2009,9353573,45000000,2.7,-35646427,Thriller
2009,7689458,40000000,6.8,-32310542,Adventure
2009,7689458,40000000,6.8,-32310542,Fantasy
2009,7689458,40000000,6.8,-32310542,Mystery
2009,7443007,30000000,6.7,-22556993,Comedy
2009,7443007,30000000,6.7,-22556993,Drama
2009,7443007,30000000,6.7,-22556993,Music
2009,49185998,30000000,7.4,19185998,Drama
2009,13248477,27000000,6.2,-13751523,Horror
2009,13248477,27000000,6.2,-13751523,Mystery
2009,13248477,27000000,6.2,-13751523,Thriller
2009,20819129,26000000,5.2,-5180871,Action
2009,20819129,26000000,5.2,-5180871,Comedy
2009,20819129,26000000,5.2,-5180871,Crime
2009,28501651,26000000,7.1,2501651,Drama
2009,28501651,26000000,7.1,2501651,Thriller
2009,25615792,25000000,3.5,615792,Action
2009,25615792,25000000,3.5,615792,Comedy
2009,25615792,25000000,3.5,615792,Music
2009,15045676,16000000,5.6,-954324,Drama
2009,15045676,16000000,5.6,-954324,Fantasy
2009,15045676,16000000,5.6,-954324,Mystery
2009,15045676,16000000,5.6,-954324,Thriller
2009,56692,25000000,7.3,-24943308,Adventure
2009,56692,25000000,7.3,-24943308,Drama
2009,1697956,20000000,6.7,-18302044,Crime
2009,1697956,20000000,6.7,-18302044,Drama
2009,32416109,25000000,6.2,7416109,Comedy
2009,32416109,25000000,6.2,7416109,War
2009,75590286,23600000,7.7,51990286,Adventure
2009,75590286,23600000,7.7,51990286,Comedy
2009,75590286,23600000,7.7,51990286,Horror
2009,75590286,23600000,7.7,51990286,Sci-Fi
2009,6109075,19430000,6.7,-13320925,Biography
2009,6109075,19430000,6.7,-13320925,Drama
2009,2708188,23000000,6.2,-20291812,Comedy
2009,2708188,23000000,6.2,-20291812,Drama
2009,2708188,23000000,6.2,-20291812,Romance
2009,33313582,21000000,6.5,12313582,Comedy
2009,33313582,21000000,6.5,12313582,Crime
2009,33313582,21000000,6.5,12313582,Drama
2009,33313582,21000000,6.5,12313582,Thriller
2009,9430988,17000000,7.1,-7569012,Comedy
2009,9430988,17000000,7.1,-7569012,Drama
2009,9430988,17000000,7.1,-7569012,Romance
2009,29975979,20000000,6.5,9975979,Action
2009,29975979,20000000,6.5,9975979,Horror
2009,29975979,20000000,6.5,9975979,Sci-Fi
2009,29975979,20000000,6.5,9975979,Thriller
2009,20916309,40000000,4.9,-19083691,Comedy
2009,20916309,40000000,4.9,-19083691,Family
2009,20916309,40000000,4.9,-19083691,Fantasy
2009,15988876,27000000,5.7,-11011124,Action
2009,15988876,27000000,5.7,-11011124,Crime
2009,15988876,27000000,5.7,-11011124,Thriller
2009,13630226,20000000,6.2,-6369774,Action
2009,13630226,20000000,6.2,-6369774,Crime
2009,13630226,20000000,6.2,-6369774,Sci-Fi
2009,13630226,20000000,6.2,-6369774,Thriller
2009,12232937,22000000,5.6,-9767063,Action
2009,12232937,22000000,5.6,-9767063,Crime
2009,12232937,22000000,5.6,-9767063,Thriller
2009,8855646,21000000,7.2,-12144354,Adventure
2009,8855646,21000000,7.2,-12144354,Drama
2009,5205343,20000000,6.4,-14794657,Comedy
2009,5205343,20000000,6.4,-14794657,Drama
2009,5205343,20000000,6.4,-14794657,Family
2009,5205343,20000000,6.4,-14794657,Music
2009,5205343,20000000,6.4,-14794657,Romance
2009,51697449,13000000,4.1,38697449,Comedy
2009,51697449,13000000,4.1,38697449,Drama
2009,18439082,18500000,6.4,-60918,Comedy
2009,18439082,18500000,6.4,-60918,Fantasy
2009,18439082,18500000,6.4,-60918,Romance
2009,23993605,18000000,5.8,5993605,Comedy
2009,23993605,18000000,5.8,5993605,Crime
2009,23993605,18000000,5.8,5993605,Drama
2009,22927390,18000000,5.6,4927390,Drama
2009,22927390,18000000,5.6,4927390,Romance
2009,22452209,18000000,5,4452209,Comedy
2009,22452209,18000000,5,4452209,Drama
2009,22452209,18000000,5,4452209,Musical
2009,22452209,18000000,5,4452209,Romance
2009,14793904,18000000,5.3,-3206096,Comedy
2009,14793904,18000000,5.3,-3206096,Romance
2009,15281286,18000000,6.5,-2718714,Comedy
2009,15281286,18000000,6.5,-2718714,Drama
2009,15281286,18000000,6.5,-2718714,Romance
2009,6615578,13000000,7,-6384422,Biography
2009,6615578,13000000,7,-6384422,Drama
2009,6615578,13000000,7,-6384422,Romance
2009,2222647,12000000,7.8,-9777353,Drama
2009,2222647,12000000,7.8,-9777353,Mystery
2009,27154426,17000000,6.7,10154426,Crime
2009,27154426,17000000,6.7,10154426,Drama
2009,27154426,17000000,6.7,10154426,Thriller
2009,8662318,17000000,5.9,-8337682,Comedy
2009,8662318,17000000,5.9,-8337682,Romance
2009,42638165,16000000,4.8,26638165,Drama
2009,42638165,16000000,4.8,26638165,Fantasy
2009,42638165,16000000,4.8,26638165,Horror
2009,42638165,16000000,4.8,26638165,Mystery
2009,42638165,16000000,4.8,26638165,Thriller
2009,16204793,16000000,5.1,204793,Comedy
2009,16204793,16000000,5.1,204793,Fantasy
2009,16204793,16000000,5.1,204793,Horror
2009,336467,13000000,7.3,-12663533,Drama
2009,336467,13000000,7.3,-12663533,Fantasy
2009,33386128,15000000,4.9,18386128,Horror
2009,32721635,15000000,6.6,17721635,Crime
2009,32721635,15000000,6.6,17721635,Horror
2009,32721635,15000000,6.6,17721635,Thriller
2009,33860010,15000000,4.8,18860010,Comedy
2009,33860010,15000000,4.8,18860010,Romance
2009,13034417,15000000,6.9,-1965583,Drama
2009,13034417,15000000,6.9,-1965583,Sport
2009,6373693,15000000,5.3,-8626307,Comedy
2009,6373693,15000000,5.3,-8626307,Romance
2009,5306447,15000000,7.2,-9693553,Comedy
2009,5306447,15000000,7.2,-9693553,Romance
2009,51527787,15000000,5.5,36527787,Horror
2009,51527787,15000000,5.5,36527787,Thriller
2009,15483540,14000000,6.5,1483540,Adventure
2009,15483540,14000000,6.5,1483540,Mystery
2009,15483540,14000000,6.5,1483540,Thriller
2009,3074838,11000000,6.3,-7925162,Drama
2009,3074838,11000000,6.3,-7925162,Mystery
2009,3074838,11000000,6.3,-7925162,Romance
2009,3074838,11000000,6.3,-7925162,Thriller
2009,28501651,26000000,7.1,2501651,Drama
2009,28501651,26000000,7.1,2501651,Thriller
2009,2035566,13000000,6.6,-10964434,Biography
2009,2035566,13000000,6.6,-10964434,Comedy
2009,2035566,13000000,6.6,-10964434,Crime
2009,2035566,13000000,6.6,-10964434,Drama
2009,2035566,13000000,6.6,-10964434,Romance
2009,11956207,16000000,5.1,-4043793,Horror
2009,11956207,16000000,5.1,-4043793,Mystery
2009,4360548,15000000,6.4,-10639452,Comedy
2009,4360548,15000000,6.4,-10639452,Drama
2009,4360548,15000000,6.4,-10639452,Romance
2009,1089445,12500000,7,-11410555,Comedy
2009,1089445,12500000,7,-11410555,Drama
2009,1089445,12500000,7,-11410555,Family
2009,1089445,12500000,7,-11410555,Sport
2009,548934,12000000,6.8,-11451066,Drama
2009,548934,12000000,6.8,-11451066,Mystery
2009,548934,12000000,6.8,-11451066,Romance
2009,119922,12000000,7.7,-11880078,Drama
2009,119922,12000000,7.7,-11880078,History
2009,119922,12000000,7.7,-11880078,War
2009,27669413,11000000,6,16669413,Horror
2009,27669413,11000000,6,16669413,Mystery
2009,47536959,10000000,7.3,37536959,Drama
2009,25464480,10000000,5.9,15464480,Mystery
2009,25464480,10000000,5.9,15464480,Sci-Fi
2009,25464480,10000000,5.9,15464480,Thriller
2009,5004648,10000000,7,-4995352,Drama
2009,5004648,10000000,7,-4995352,Romance
2009,1474508,5000000,6.5,-3525492,Comedy
2009,1474508,5000000,6.5,-3525492,Drama
2009,19348,10000000,5.5,-9980652,Comedy
2009,19348,10000000,5.5,-9980652,Drama
2009,100503,8000000,5.9,-7899497,Comedy
2009,100503,8000000,5.9,-7899497,Romance
2009,92900,5000000,4.7,-4907100,Comedy
2009,92900,5000000,4.7,-4907100,Drama
2009,883887,9000000,6.2,-8116113,Drama
2009,39462438,7000000,7.3,32462438,Drama
2009,39462438,7000000,7.3,32462438,Music
2009,39462438,7000000,7.3,32462438,Romance
2009,4440055,8500000,7,-4059945,Biography
2009,4440055,8500000,7,-4059945,Drama
2009,4440055,8500000,7,-4059945,Romance
2009,16699684,8000000,5.6,8699684,Comedy
2009,16699684,8000000,5.6,8699684,Romance
2009,10269307,8000000,6.3,2269307,Action
2009,10269307,8000000,6.3,2269307,Crime
2009,10269307,8000000,6.3,2269307,Thriller
2009,686383,6500000,7.7,-5813617,Adventure
2009,686383,6500000,7.7,-5813617,Animation
2009,686383,6500000,7.7,-5813617,Family
2009,686383,6500000,7.7,-5813617,Fantasy
2009,12574715,4500000,7.3,8074715,Drama
2009,10814185,8000000,6.2,2814185,Comedy
2009,10814185,8000000,6.2,2814185,Crime
2009,10814185,8000000,6.2,2814185,Romance
2009,1818681,7300000,7.2,-5481319,Action
2009,1818681,7300000,7.2,-5481319,Crime
2009,1818681,7300000,7.2,-5481319,Drama
2009,1818681,7300000,7.2,-5481319,Thriller
2009,32391374,7500000,7.7,24891374,Comedy
2009,32391374,7500000,7.7,24891374,Drama
2009,32391374,7500000,7.7,24891374,Romance
2009,9190525,7000000,7,2190525,Comedy
2009,9190525,7000000,7,2190525,Drama
2009,9176553,7500000,7.1,1676553,Drama
2009,9176553,7500000,7.1,1676553,Mystery
2009,9166863,7000000,7.6,2166863,Drama
2009,9166863,7000000,7.6,2166863,Romance
2009,1889522,7000000,6.5,-5110478,Drama
2009,1889522,7000000,6.5,-5110478,Sport
2009,1110286,4825000,7.2,-3714714,Drama
2009,1110286,4825000,7.2,-3714714,Romance
2009,110029,6500000,6.3,-6389971,Comedy
2009,110029,6500000,6.3,-6389971,Drama
2009,110029,6500000,6.3,-6389971,Musical
2009,66637,6500000,7.2,-6433363,Drama
2009,66637,6500000,7.2,-6433363,Romance
2009,66637,6500000,7.2,-6433363,War
2009,449558,10000000,7.6,-9550442,Biography
2009,449558,10000000,7.6,-9550442,Drama
2009,449558,10000000,7.6,-9550442,Sport
2009,6670712,6000000,7.4,670712,Comedy
2009,6670712,6000000,7.4,670712,Drama
2009,4542775,6000000,5.1,-1457225,Comedy
2009,4542775,6000000,5.1,-1457225,Romance
2009,115862,6000000,6.7,-5884138,Drama
2009,115862,6000000,6.7,-5884138,Romance
2009,27024,5600000,6.6,-5572976,Horror
2009,10572742,8000000,6.1,2572742,Drama
2009,10572742,8000000,6.1,2572742,Romance
2009,5009677,5000000,7.9,9677,Drama
2009,5009677,5000000,7.9,9677,Mystery
2009,5009677,5000000,7.9,9677,Sci-Fi
2009,274385,4000000,7.3,-3725615,Comedy
2009,274385,4000000,7.3,-3725615,Drama
2009,108229,4500000,5.9,-4391771,Drama
2009,108229,4500000,5.9,-4391771,Horror
2009,108229,4500000,5.9,-4391771,Mystery
2009,108229,4500000,5.9,-4391771,Thriller
2009,199228,150000000,7.2,-149800772,Comedy
2009,199228,150000000,7.2,-149800772,Drama
2009,101055,4000000,5,-3898945,Horror
2009,37606,3500000,6.8,-3462394,Comedy
2009,37606,3500000,6.8,-3462394,Crime
2009,37606,3500000,6.8,-3462394,Drama
2009,19959,3800000,6.9,-3780041,Drama
2009,20167424,2000000,8.2,18167424,Drama
2009,20167424,2000000,8.2,18167424,Mystery
2009,20167424,2000000,8.2,18167424,Thriller
2009,10017041,3000000,5.9,7017041,Action
2009,10017041,3000000,5.9,7017041,Comedy
2009,10017041,3000000,5.9,7017041,Crime
2009,143000,5000000,4.1,-4857000,Horror
2009,143000,5000000,4.1,-4857000,Thriller
2009,5005,3000000,5.9,-2994995,Drama
2009,33386128,15000000,4.9,18386128,Horror
2009,100669,3800000,5.8,-3699331,Comedy
2009,100669,3800000,5.8,-3699331,Drama
2009,17580,1500000,6.2,-1482420,Drama
2009,43982842,65000000,6.7,-21017158,Drama
2009,43982842,65000000,6.7,-21017158,Fantasy
2009,43982842,65000000,6.7,-21017158,Thriller
2009,100659,900000,6.4,-799341,Horror
2009,41709,800000,6.4,-758291,Comedy
2009,41709,800000,6.4,-758291,Horror
2009,42638165,16000000,4.8,26638165,Drama
2009,42638165,16000000,4.8,26638165,Fantasy
2009,42638165,16000000,4.8,26638165,Horror
2009,42638165,16000000,4.8,26638165,Mystery
2009,42638165,16000000,4.8,26638165,Thriller
2009,3773863,1000000,7.1,2773863,Drama
2009,155984,160000,7.4,-4016,Documentary
2009,32721635,15000000,6.6,17721635,Crime
2009,32721635,15000000,6.6,17721635,Horror
2009,32721635,15000000,6.6,17721635,Thriller
2009,76382,15000,6.2,61382,Romance
2008,168368427,200000000,6.7,-31631573,Action
2008,168368427,200000000,6.7,-31631573,Adventure
2008,141614023,225000000,6.6,-83385977,Action
2008,141614023,225000000,6.6,-83385977,Adventure
2008,141614023,225000000,6.6,-83385977,Family
2008,141614023,225000000,6.6,-83385977,Fantasy
2008,317011114,185000000,6.2,132011114,Action
2008,317011114,185000000,6.2,132011114,Adventure
2008,317011114,185000000,6.2,132011114,Fantasy
2008,223806889,180000000,8.4,43806889,Adventure
2008,223806889,180000000,8.4,43806889,Animation
2008,223806889,180000000,8.4,43806889,Family
2008,223806889,180000000,8.4,43806889,Sci-Fi
2008,533316061,185000000,9,348316061,Action
2008,533316061,185000000,9,348316061,Crime
2008,533316061,185000000,9,348316061,Drama
2008,533316061,185000000,9,348316061,Thriller
2008,318298180,140000000,7.9,178298180,Action
2008,318298180,140000000,7.9,178298180,Adventure
2008,318298180,140000000,7.9,178298180,Sci-Fi
2008,102176165,145000000,5.2,-42823835,Action
2008,102176165,145000000,5.2,-42823835,Adventure
2008,102176165,145000000,5.2,-42823835,Fantasy
2008,102176165,145000000,5.2,-42823835,Horror
2008,102176165,145000000,5.2,-42823835,Thriller
2008,127490802,150000000,7.8,-22509198,Drama
2008,127490802,150000000,7.8,-22509198,Fantasy
2008,127490802,150000000,7.8,-22509198,Romance
2008,227946274,150000000,6.4,77946274,Action
2008,227946274,150000000,6.4,77946274,Drama
2008,179982968,150000000,6.7,29982968,Action
2008,179982968,150000000,6.7,29982968,Adventure
2008,179982968,150000000,6.7,29982968,Animation
2008,179982968,150000000,6.7,29982968,Comedy
2008,179982968,150000000,6.7,29982968,Family
2008,114053579,150000000,6.9,-35946421,Adventure
2008,114053579,150000000,6.9,-35946421,Animation
2008,114053579,150000000,6.9,-35946421,Comedy
2008,114053579,150000000,6.9,-35946421,Drama
2008,114053579,150000000,6.9,-35946421,Family
2008,134518390,150000000,6.8,-15481610,Action
2008,134518390,150000000,6.8,-15481610,Adventure
2008,134518390,150000000,6.8,-15481610,Sci-Fi
2008,215395021,130000000,7.6,85395021,Action
2008,215395021,130000000,7.6,85395021,Adventure
2008,215395021,130000000,7.6,85395021,Animation
2008,215395021,130000000,7.6,85395021,Comedy
2008,215395021,130000000,7.6,85395021,Family
2008,49551662,130000000,6.6,-80448338,Adventure
2008,49551662,130000000,6.6,-80448338,Drama
2008,49551662,130000000,6.6,-80448338,Romance
2008,49551662,130000000,6.6,-80448338,War
2008,43929341,120000000,6.1,-76070659,Action
2008,43929341,120000000,6.1,-76070659,Family
2008,43929341,120000000,6.1,-76070659,Sport
2008,71148699,90000000,6.6,-18851301,Adventure
2008,71148699,90000000,6.6,-18851301,Family
2008,71148699,90000000,6.6,-18851301,Fantasy
2008,110416702,92000000,7,18416702,Action
2008,110416702,92000000,7,18416702,Comedy
2008,83077470,75000000,7.1,8077470,Drama
2008,83077470,75000000,7.1,8077470,History
2008,83077470,75000000,7.1,8077470,Thriller
2008,83077470,75000000,7.1,8077470,War
2008,100018837,90000000,5.5,10018837,Action
2008,100018837,90000000,5.5,10018837,Comedy
2008,80170146,85000000,6.1,-4829854,Action
2008,80170146,85000000,6.1,-4829854,Adventure
2008,80170146,85000000,6.1,-4829854,Sci-Fi
2008,80170146,85000000,6.1,-4829854,Thriller
2008,75754670,85000000,7,-9245330,Action
2008,75754670,85000000,7,-9245330,Adventure
2008,75754670,85000000,7,-9245330,Fantasy
2008,75754670,85000000,7,-9245330,Horror
2008,75754670,85000000,7,-9245330,Sci-Fi
2008,130313314,80000000,6.5,50313314,Action
2008,130313314,80000000,6.5,50313314,Adventure
2008,130313314,80000000,6.5,50313314,Comedy
2008,120136047,80000000,5.6,40136047,Comedy
2008,120136047,80000000,5.6,40136047,Drama
2008,120136047,80000000,5.6,40136047,Romance
2008,109993847,80000000,6.1,29993847,Comedy
2008,109993847,80000000,6.1,29993847,Family
2008,109993847,80000000,6.1,29993847,Fantasy
2008,109993847,80000000,6.1,29993847,Romance
2008,101111837,80000000,6.6,21111837,Action
2008,101111837,80000000,6.6,21111837,Mystery
2008,101111837,80000000,6.6,21111837,Thriller
2008,79363785,80000000,5.5,-636215,Drama
2008,79363785,80000000,5.5,-636215,Sci-Fi
2008,79363785,80000000,5.5,-636215,Thriller
2008,134568845,75000000,6.7,59568845,Action
2008,134568845,75000000,6.7,59568845,Crime
2008,134568845,75000000,6.7,59568845,Fantasy
2008,134568845,75000000,6.7,59568845,Thriller
2008,70224196,70000000,5.6,224196,Action
2008,70224196,70000000,5.6,224196,Adventure
2008,70224196,70000000,5.6,224196,Comedy
2008,70224196,70000000,5.6,224196,Romance
2008,70224196,70000000,5.6,224196,Thriller
2008,39380442,70000000,7.1,-30619558,Action
2008,39380442,70000000,7.1,-30619558,Drama
2008,39380442,70000000,7.1,-30619558,Thriller
2008,100468793,65000000,6.9,35468793,Comedy
2008,36064910,45000000,6.4,-8935090,Action
2008,36064910,45000000,6.4,-8935090,Sci-Fi
2008,36064910,45000000,6.4,-8935090,Thriller
2008,32178777,62000000,3.8,-29821223,Comedy
2008,32178777,62000000,3.8,-29821223,Romance
2008,32178777,62000000,3.8,-29821223,Sport
2008,143151473,60000000,7.1,83151473,Comedy
2008,143151473,60000000,7.1,83151473,Drama
2008,143151473,60000000,7.1,83151473,Family
2008,64505912,48000000,5,16505912,Sci-Fi
2008,64505912,48000000,5,16505912,Thriller
2008,50818750,60000000,6.1,-9181250,Adventure
2008,50818750,60000000,6.1,-9181250,Animation
2008,50818750,60000000,6.1,-9181250,Comedy
2008,50818750,60000000,6.1,-9181250,Family
2008,50818750,60000000,6.1,-9181250,Fantasy
2008,40076438,60000000,6,-19923562,Action
2008,40076438,60000000,6,-19923562,Crime
2008,40076438,60000000,6,-19923562,Drama
2008,40076438,60000000,6,-19923562,Mystery
2008,40076438,60000000,6,-19923562,Thriller
2008,11802056,60000000,4.9,-48197944,Adventure
2008,11802056,60000000,4.9,-48197944,Comedy
2008,11802056,60000000,4.9,-48197944,Family
2008,11802056,60000000,4.9,-48197944,Romance
2008,11802056,60000000,4.9,-48197944,Sci-Fi
2008,17281832,60000000,6.1,-42718168,Adventure
2008,17281832,60000000,6.1,-42718168,Family
2008,17281832,60000000,6.1,-42718168,Fantasy
2008,19781879,60000000,4.8,-40218121,Action
2008,19781879,60000000,4.8,-40218121,Crime
2008,19781879,60000000,4.8,-40218121,Fantasy
2008,19781879,60000000,4.8,-40218121,Thriller
2008,31199215,58000000,6,-26800785,Comedy
2008,31199215,58000000,6,-26800785,Drama
2008,31199215,58000000,6,-26800785,Romance
2008,31199215,58000000,6,-26800785,Sport
2008,25040293,55000000,6.6,-29959707,Action
2008,25040293,55000000,6.6,-29959707,Adventure
2008,25040293,55000000,6.6,-29959707,Fantasy
2008,33472850,55000000,5.8,-21527150,Comedy
2008,33472850,55000000,5.8,-21527150,Sport
2008,35707327,55000000,7.8,-19292673,Crime
2008,35707327,55000000,7.8,-19292673,Drama
2008,35707327,55000000,7.8,-19292673,Mystery
2008,35707327,55000000,7.8,-19292673,Thriller
2008,69951824,55000000,7.7,14951824,Drama
2008,69951824,55000000,7.7,14951824,Romance
2008,143704210,52000000,6.3,91704210,Comedy
2008,143704210,52000000,6.3,91704210,Family
2008,143704210,52000000,6.3,91704210,Musical
2008,143704210,52000000,6.3,91704210,Romance
2008,97680195,70000000,6.8,27680195,Comedy
2008,97680195,70000000,6.8,27680195,Romance
2008,101702060,45000000,5.8,56702060,Action
2008,101702060,45000000,5.8,56702060,Adventure
2008,101702060,45000000,5.8,56702060,Family
2008,101702060,45000000,5.8,56702060,Fantasy
2008,101702060,45000000,5.8,56702060,Sci-Fi
2008,22877808,35000000,7.3,-12122192,Drama
2008,22877808,35000000,7.3,-12122192,Romance
2008,22531698,70000000,5.6,-47468302,Action
2008,22531698,70000000,5.6,-47468302,Adventure
2008,22531698,70000000,5.6,-47468302,Sci-Fi
2008,22531698,70000000,5.6,-47468302,Thriller
2008,7916887,45000000,6,-37083113,Action
2008,7916887,45000000,6,-37083113,Crime
2008,7916887,45000000,6,-37083113,Drama
2008,7916887,45000000,6,-37083113,Thriller
2008,7916887,45000000,6,-37083113,War
2008,15279680,40000000,5.4,-24720320,Action
2008,15279680,40000000,5.4,-24720320,Crime
2008,15279680,40000000,5.4,-24720320,Thriller
2008,72266306,40000000,6.6,32266306,Crime
2008,72266306,40000000,6.6,32266306,Drama
2008,72266306,40000000,6.6,32266306,Mystery
2008,72266306,40000000,6.6,32266306,Thriller
2008,46012734,40000000,5.8,6012734,Comedy
2008,46012734,40000000,5.8,6012734,Romance
2008,32853640,40000000,5.7,-7146360,Comedy
2008,32853640,40000000,5.7,-7146360,Drama
2008,26814957,35000000,6.7,-8185043,Biography
2008,26814957,35000000,6.7,-8185043,Drama
2008,26814957,35000000,6.7,-8185043,History
2008,26814957,35000000,6.7,-8185043,Romance
2008,511920,40000000,4.4,-39488080,Adventure
2008,511920,40000000,4.4,-39488080,Animation
2008,511920,40000000,4.4,-39488080,Comedy
2008,511920,40000000,4.4,-39488080,Fantasy
2008,511920,40000000,4.4,-39488080,Romance
2008,626809,553632000,7.4,-553005191,Action
2008,626809,553632000,7.4,-553005191,Adventure
2008,626809,553632000,7.4,-553005191,Drama
2008,626809,553632000,7.4,-553005191,History
2008,626809,553632000,7.4,-553005191,War
2008,7871693,55000000,6.5,-47128307,Adventure
2008,7871693,55000000,6.5,-47128307,Family
2008,7871693,55000000,6.5,-47128307,Fantasy
2008,7871693,55000000,6.5,-47128307,Sci-Fi
2008,9589875,40000000,7.3,-30410125,Biography
2008,9589875,40000000,7.3,-30410125,Drama
2008,9589875,40000000,7.3,-30410125,Sport
2008,60338891,37000000,7,23338891,Comedy
2008,60338891,37000000,7,23338891,Drama
2008,48006503,37000000,6,11006503,Adventure
2008,48006503,37000000,6,11006503,Comedy
2008,48006503,37000000,6,11006503,Family
2008,48006503,37000000,6,11006503,Fantasy
2008,191449475,37000000,5.2,154449475,Drama
2008,191449475,37000000,5.2,154449475,Fantasy
2008,191449475,37000000,5.2,154449475,Romance
2008,30105968,37000000,4.5,-6894032,Adventure
2008,30105968,37000000,4.5,-6894032,Animation
2008,30105968,37000000,4.5,-6894032,Comedy
2008,30105968,37000000,4.5,-6894032,Family
2008,30105968,37000000,4.5,-6894032,Sci-Fi
2008,81159365,35000000,6.8,46159365,Crime
2008,81159365,35000000,6.8,46159365,Drama
2008,81159365,35000000,6.8,46159365,Thriller
2008,40687294,35000000,5.4,5687294,Action
2008,40687294,35000000,5.4,5687294,Crime
2008,40687294,35000000,5.4,5687294,Drama
2008,40687294,35000000,5.4,5687294,Mystery
2008,40687294,35000000,5.4,5687294,Thriller
2008,30691439,35000000,6.2,-4308561,Horror
2008,30691439,35000000,6.2,-4308561,Mystery
2008,28687835,35000000,6.2,-6312165,Crime
2008,28687835,35000000,6.2,-6312165,Drama
2008,28687835,35000000,6.2,-6312165,Thriller
2008,20981633,30000000,5.9,-9018367,Drama
2008,20981633,30000000,5.9,-9018367,Mystery
2008,20981633,30000000,5.9,-9018367,Sci-Fi
2008,20981633,30000000,5.9,-9018367,Thriller
2008,25871834,35000000,4.5,-9128166,Action
2008,25871834,35000000,4.5,-9128166,Comedy
2008,25871834,35000000,4.5,-9128166,Sci-Fi
2008,25871834,35000000,4.5,-9128166,Thriller
2008,7948159,35000000,6,-27051841,Action
2008,7948159,35000000,6,-27051841,Crime
2008,7948159,35000000,6,-27051841,Drama
2008,7948159,35000000,6,-27051841,Thriller
2008,15081783,34000000,7.7,-18918217,Adventure
2008,15081783,34000000,7.7,-18918217,Animation
2008,15081783,34000000,7.7,-18918217,Family
2008,15081783,34000000,7.7,-18918217,Fantasy
2008,10955425,30000000,6,-19044575,Action
2008,10955425,30000000,6,-19044575,Sci-Fi
2008,10955425,30000000,6,-19044575,Thriller
2008,34180954,32000000,7.6,2180954,Drama
2008,34180954,32000000,7.6,2180954,Romance
2008,76806312,30000000,6.1,46806312,Comedy
2008,76806312,30000000,6.1,46806312,Romance
2008,62877175,30000000,7.2,32877175,Comedy
2008,62877175,30000000,7.2,32877175,Drama
2008,62877175,30000000,7.2,32877175,Romance
2008,60269340,30000000,6,30269340,Comedy
2008,60269340,30000000,6,30269340,Romance
2008,38232624,30000000,2.7,8232624,Comedy
2008,15709385,30000000,6.7,-14290615,Crime
2008,15709385,30000000,6.7,-14290615,Drama
2008,15709385,30000000,6.7,-14290615,Thriller
2008,18593156,35000000,7.7,-16406844,Drama
2008,67266300,28000000,6.9,39266300,Comedy
2008,2775593,27000000,6.5,-24224407,Comedy
2008,2775593,27000000,6.5,-24224407,Drama
2008,2775593,27000000,6.5,-24224407,Romance
2008,42168445,35000000,5.3,7168445,Comedy
2008,42168445,35000000,5.3,7168445,Drama
2008,42168445,35000000,5.3,7168445,Romance
2008,13823741,13500000,6.9,323741,Biography
2008,13823741,13500000,6.9,323741,Drama
2008,13823741,13500000,6.9,323741,History
2008,13823741,13500000,6.9,323741,Romance
2008,1089365,25000000,5.7,-23910635,Comedy
2008,1089365,25000000,5.7,-23910635,Drama
2008,87341380,27000000,7,60341380,Action
2008,87341380,27000000,7,60341380,Comedy
2008,87341380,27000000,7,60341380,Crime
2008,148085755,33000000,8.2,115085755,Drama
2008,25517500,25100000,6.4,417500,Biography
2008,25517500,25100000,6.4,417500,Drama
2008,25517500,25100000,6.4,417500,History
2008,145000989,25000000,7.9,120000989,Action
2008,145000989,25000000,7.9,120000989,Thriller
2008,80034302,25000000,7,55034302,Action
2008,80034302,25000000,7,55034302,Adventure
2008,80034302,25000000,7,55034302,Horror
2008,80034302,25000000,7,55034302,Sci-Fi
2008,48237389,25000000,5.5,23237389,Comedy
2008,48237389,25000000,5.5,23237389,Romance
2008,17427926,8000000,5.9,9427926,Horror
2008,10911750,25000000,6.5,-14088250,Drama
2008,10911750,25000000,6.5,-14088250,War
2008,3073392,25000000,6.6,-21926608,Drama
2008,3073392,25000000,6.6,-21926608,Mystery
2008,3073392,25000000,6.6,-21926608,Sci-Fi
2008,3073392,25000000,6.6,-21926608,Thriller
2008,1186957,25000000,6.8,-23813043,Drama
2008,31452765,24000000,6.6,7452765,Comedy
2008,31452765,24000000,6.6,7452765,Romance
2008,11508423,23000000,5.1,-11491577,Biography
2008,11508423,23000000,5.1,-11491577,Comedy
2008,11508423,23000000,5.1,-11491577,Drama
2008,11508423,23000000,5.1,-11491577,Family
2008,11508423,23000000,5.1,-11491577,Sport
2008,20668843,22000000,5.8,-1331157,Comedy
2008,20668843,22000000,5.8,-1331157,Crime
2008,20668843,22000000,5.8,-1331157,Thriller
2008,24848292,20000000,6.6,4848292,Action
2008,24848292,20000000,6.6,4848292,Drama
2008,24848292,20000000,6.6,4848292,Sport
2008,16284360,21000000,6.1,-4715640,Comedy
2008,16284360,21000000,6.1,-4715640,Drama
2008,94497271,20000000,3.7,74497271,Adventure
2008,94497271,20000000,3.7,74497271,Comedy
2008,94497271,20000000,3.7,74497271,Drama
2008,94497271,20000000,3.7,74497271,Family
2008,94497271,20000000,3.7,74497271,Romance
2008,39263506,22000000,6.1,17263506,Crime
2008,39263506,22000000,6.1,17263506,Drama
2008,39263506,22000000,6.1,17263506,Thriller
2008,33422556,20000000,7.5,13422556,Drama
2008,33422556,20000000,7.5,13422556,Mystery
2008,31838002,20000000,7.6,11838002,Biography
2008,31838002,20000000,7.6,11838002,Drama
2008,31838002,20000000,7.6,11838002,History
2008,26876529,27000000,3.9,-123471,Horror
2008,26876529,27000000,3.9,-123471,Mystery
2008,30028592,20000000,7.3,10028592,Crime
2008,30028592,20000000,7.3,10028592,Drama
2008,30028592,20000000,7.3,10028592,Romance
2008,30028592,20000000,7.3,10028592,Thriller
2008,26415649,20000000,6.8,6415649,Action
2008,26415649,20000000,6.8,6415649,Crime
2008,26415649,20000000,6.8,6415649,Drama
2008,26415649,20000000,6.8,6415649,Thriller
2008,19151864,40000000,5.9,-20848136,Comedy
2008,19151864,40000000,5.9,-20848136,Romance
2008,191449475,37000000,5.2,154449475,Drama
2008,191449475,37000000,5.2,154449475,Fantasy
2008,191449475,37000000,5.2,154449475,Romance
2008,14174654,25000000,1.9,-10825346,Comedy
2008,13214030,20000000,6.7,-6785970,Comedy
2008,13214030,20000000,6.7,-6785970,Drama
2008,13214030,20000000,6.7,-6785970,Fantasy
2008,13214030,20000000,6.7,-6785970,Romance
2008,11169531,20000000,6.4,-8830469,Comedy
2008,7001720,12000000,4.3,-4998280,Comedy
2008,7001720,12000000,4.3,-4998280,Fantasy
2008,6563357,20000000,5.3,-13436643,Adventure
2008,6563357,20000000,5.3,-13436643,Comedy
2008,4234040,20000000,7,-15765960,Biography
2008,4234040,20000000,7,-15765960,Drama
2008,3519627,20000000,6.9,-16480373,Adventure
2008,3519627,20000000,6.9,-16480373,Comedy
2008,3519627,20000000,6.9,-16480373,Drama
2008,3519627,20000000,6.9,-16480373,Romance
2008,3081925,21000000,7.5,-17918075,Comedy
2008,3081925,21000000,7.5,-17918075,Drama
2008,3081925,21000000,7.5,-17918075,Romance
2008,1027749,40000000,7.1,-38972251,Drama
2008,1027749,40000000,7.1,-38972251,War
2008,476270,20000000,7.4,-19523730,Action
2008,476270,20000000,7.4,-19523730,Biography
2008,476270,20000000,7.4,-19523730,Crime
2008,476270,20000000,7.4,-19523730,Drama
2008,8396942,19000000,6.5,-10603058,Adventure
2008,8396942,19000000,6.5,-10603058,Comedy
2008,8396942,19000000,6.5,-10603058,Romance
2008,43818159,20000000,3.9,23818159,Horror
2008,43818159,20000000,3.9,23818159,Mystery
2008,5694401,18000000,7.3,-12305599,Action
2008,5694401,18000000,7.3,-12305599,Crime
2008,5694401,18000000,7.3,-12305599,Thriller
2008,58006147,23000000,6.2,35006147,Drama
2008,58006147,23000000,6.2,35006147,Music
2008,58006147,23000000,6.2,35006147,Musical
2008,58006147,23000000,6.2,35006147,Romance
2008,26896744,16500000,4.9,10396744,Comedy
2008,26896744,16500000,4.9,10396744,Drama
2008,23213577,15500000,7.2,7713577,Drama
2008,23213577,15500000,7.2,7713577,Romance
2008,23091,15000000,6.2,-14976909,Drama
2008,23091,15000000,6.2,-14976909,Romance
2008,23091,15000000,6.2,-14976909,War
2008,317040,15500000,6.8,-15182960,Drama
2008,317040,15500000,6.8,-15182960,Romance
2008,15700000,15000000,7.6,700000,Drama
2008,15700000,15000000,7.6,700000,History
2008,15700000,15000000,7.6,700000,Thriller
2008,15700000,15000000,7.6,700000,War
2008,12701880,15000000,5.7,-2298120,Adventure
2008,12701880,15000000,5.7,-2298120,Animation
2008,12701880,15000000,5.7,-2298120,Comedy
2008,12701880,15000000,5.7,-2298120,Family
2008,7757130,15000000,8,-7242870,Comedy
2008,7757130,15000000,8,-7242870,Crime
2008,7757130,15000000,8,-7242870,Drama
2008,6409206,15000000,6.2,-8590794,Comedy
2008,6409206,15000000,6.2,-8590794,Music
2008,2203641,15000000,6.7,-12796359,Crime
2008,2203641,15000000,6.7,-12796359,Drama
2008,2203641,15000000,6.7,-12796359,Mystery
2008,2203641,15000000,6.7,-12796359,Thriller
2008,102055,300000000,6.2,-299897945,Action
2008,73548,15000000,6.1,-14926452,Fantasy
2008,73548,15000000,6.1,-14926452,Horror
2008,73548,15000000,6.1,-14926452,Mystery
2008,141319195,15000000,8,126319195,Drama
2008,141319195,15000000,8,126319195,Romance
2008,183088,15000000,7,-14816912,Comedy
2008,183088,15000000,7,-14816912,Drama
2008,183088,15000000,7,-14816912,War
2008,9030581,12500000,7.8,-3469419,Drama
2008,9030581,12500000,7.8,-3469419,War
2008,38087366,12000000,6.6,26087366,Adventure
2008,38087366,12000000,6.6,26087366,Comedy
2008,31691811,12000000,6,19691811,Horror
2008,31691811,12000000,6,19691811,Sci-Fi
2008,31691811,12000000,6,19691811,Thriller
2008,31397498,12000000,5.4,19397498,Horror
2008,31397498,12000000,5.4,19397498,Mystery
2008,8134217,12000000,7,-3865783,Biography
2008,8134217,12000000,7,-3865783,Drama
2008,8134217,12000000,7,-3865783,Music
2008,3148482,12000000,7.1,-8851518,Drama
2008,3148482,12000000,7.1,-8851518,Romance
2008,90556401,11000000,4.5,79556401,Comedy
2008,90556401,11000000,4.5,79556401,Drama
2008,90556401,11000000,4.5,79556401,Family
2008,90556401,11000000,4.5,79556401,Music
2008,90556401,11000000,4.5,79556401,Musical
2008,90556401,11000000,4.5,79556401,Romance
2008,37766350,11000000,7.3,26766350,Drama
2008,56729973,10800000,5.8,45929973,Horror
2008,56729973,10800000,5.8,45929973,Mystery
2008,31487293,9000000,6.7,22487293,Comedy
2008,31487293,9000000,6.7,22487293,Drama
2008,31487293,9000000,6.7,22487293,Music
2008,31487293,9000000,6.7,22487293,Romance
2008,17655201,10000000,6.7,7655201,Drama
2008,17655201,10000000,6.7,7655201,Family
2008,7563670,10000000,5.2,-2436330,Comedy
2008,7563670,10000000,5.2,-2436330,Fantasy
2008,7563670,10000000,5.2,-2436330,Romance
2008,578527,10000000,5.7,-9421473,Action
2008,578527,10000000,5.7,-9421473,Comedy
2008,578527,10000000,5.7,-9421473,Thriller
2008,3607,10000000,6.1,-9996393,Crime
2008,3607,10000000,6.1,-9996393,Mystery
2008,3607,10000000,6.1,-9996393,Thriller
2008,128486,10000000,7.3,-9871514,Action
2008,128486,10000000,7.3,-9871514,Adventure
2008,128486,10000000,7.3,-9871514,Comedy
2008,128486,10000000,7.3,-9871514,Western
2008,4881867,9000000,6.4,-4118133,Comedy
2008,4881867,9000000,6.4,-4118133,Music
2008,145109,45000000,7.3,-44854891,Drama
2008,145109,45000000,7.3,-44854891,History
2008,145109,45000000,7.3,-44854891,Thriller
2008,145109,45000000,7.3,-44854891,War
2008,140244,8500000,6.7,-8359756,Horror
2008,140244,8500000,6.7,-8359756,Musical
2008,140244,8500000,6.7,-8359756,Sci-Fi
2008,25926543,8000000,5.2,17926543,Horror
2008,25926543,8000000,5.2,17926543,Mystery
2008,25926543,8000000,5.2,17926543,Thriller
2008,108662,8000000,6,-7891338,Crime
2008,108662,8000000,6,-7891338,Horror
2008,108662,8000000,6,-7891338,Thriller
2008,4131640,7500000,3.1,-3368360,Comedy
2008,4131640,7500000,3.1,-3368360,Crime
2008,2344847,7000000,6.8,-4655153,Drama
2008,2344847,7000000,6.8,-4655153,Sport
2008,26236603,6000000,7.9,20236603,Drama
2008,26236603,6000000,7.9,20236603,Sport
2008,7518876,6000000,6.5,1518876,Adventure
2008,7518876,6000000,6.5,1518876,Documentary
2008,7518876,6000000,6.5,1518876,Short
2008,4693919,6500000,4.6,-1806081,Comedy
2008,2077046,6000000,7,-3922954,Comedy
2008,2077046,6000000,7,-3922954,Drama
2008,2077046,6000000,7,-3922954,Romance
2008,36497,6000000,4.7,-5963503,Comedy
2008,542860,4000000,7.1,-3457140,Drama
2008,542860,4000000,7.1,-3457140,History
2008,542860,4000000,7.1,-3457140,War
2008,13350177,5000000,3.8,8350177,Drama
2008,13350177,5000000,3.8,8350177,Horror
2008,13350177,5000000,3.8,8350177,Thriller
2008,12055108,8000000,6.9,4055108,Comedy
2008,12055108,8000000,6.9,4055108,Drama
2008,4040588,5000000,6.8,-959412,Comedy
2008,4040588,5000000,6.8,-959412,Drama
2008,124720,5000000,7.3,-4875280,Drama
2008,124720,5000000,7.3,-4875280,Romance
2008,2926565,3000000,6.5,-73435,Comedy
2008,2926565,3000000,6.5,-73435,Drama
2008,12995673,2500000,7.7,10495673,Comedy
2008,12995673,2500000,7.7,10495673,Documentary
2008,12995673,2500000,7.7,10495673,War
2008,173783,2500000,7.6,-2326217,Documentary
2008,115504,14000000,6.2,-13884496,Comedy
2008,115504,14000000,6.2,-13884496,Drama
2008,115504,14000000,6.2,-13884496,Romance
2008,75727,2500000,5.9,-2424273,Drama
2008,75727,2500000,5.9,-2424273,Romance
2008,75727,2500000,5.9,-2424273,Sci-Fi
2008,75727,2500000,5.9,-2424273,Thriller
2008,2283276,1500000,8,783276,Animation
2008,2283276,1500000,8,783276,Biography
2008,2283276,1500000,8,783276,Documentary
2008,2283276,1500000,8,783276,Drama
2008,2283276,1500000,8,783276,History
2008,2283276,1500000,8,783276,War
2008,4958,2000000,7.8,-1995042,Action
2008,4958,2000000,7.8,-1995042,Crime
2008,4958,2000000,7.8,-1995042,Drama
2008,2957978,1000000,7.8,1957978,Biography
2008,2957978,1000000,7.8,1957978,Crime
2008,2957978,1000000,7.8,1957978,Documentary
2008,2957978,1000000,7.8,1957978,History
2008,2957978,1000000,7.8,1957978,Thriller
2008,3478,1500000,6.7,-1496522,Fantasy
2008,3478,1500000,6.7,-1496522,Horror
2008,52166,2000000,6.7,-1947834,Drama
2008,79363785,80000000,5.5,-636215,Drama
2008,79363785,80000000,5.5,-636215,Sci-Fi
2008,79363785,80000000,5.5,-636215,Thriller
2008,2508841,1000000,7.2,1508841,Crime
2008,2508841,1000000,7.2,1508841,Drama
2008,18378,900000,5.2,-881622,Crime
2008,18378,900000,5.2,-881622,Drama
2008,18378,900000,5.2,-881622,Horror
2008,18378,900000,5.2,-881622,Thriller
2008,33451479,500000,6.5,32951479,Drama
2008,33451479,500000,6.5,32951479,Romance
2008,80276912,35000000,6.1,45276912,Comedy
2008,80276912,35000000,6.1,45276912,Romance
2008,856942,200000,7.1,656942,Drama
2008,215185,200000,7.5,15185,Documentary
2008,215185,200000,7.5,15185,History
2008,215185,200000,7.5,15185,Music
2007,309404152,300000000,7.1,9404152,Action
2007,309404152,300000000,7.1,9404152,Adventure
2007,309404152,300000000,7.1,9404152,Fantasy
2007,336530303,258000000,6.2,78530303,Action
2007,336530303,258000000,6.2,78530303,Adventure
2007,336530303,258000000,6.2,78530303,Romance
2007,70083519,180000000,6.1,-109916481,Adventure
2007,70083519,180000000,6.1,-109916481,Family
2007,70083519,180000000,6.1,-109916481,Fantasy
2007,140080850,140000000,6.2,80850,Action
2007,140080850,140000000,6.2,80850,Comedy
2007,140080850,140000000,6.2,80850,Crime
2007,140080850,140000000,6.2,80850,Thriller
2007,100289690,175000000,5.4,-74710310,Comedy
2007,100289690,175000000,5.4,-74710310,Family
2007,100289690,175000000,5.4,-74710310,Fantasy
2007,320706665,160000000,6.1,160706665,Adventure
2007,320706665,160000000,6.1,160706665,Animation
2007,320706665,160000000,6.1,160706665,Comedy
2007,320706665,160000000,6.1,160706665,Family
2007,320706665,160000000,6.1,160706665,Fantasy
2007,318759914,150000000,7.1,168759914,Action
2007,318759914,150000000,7.1,168759914,Adventure
2007,318759914,150000000,7.1,168759914,Sci-Fi
2007,292000866,150000000,7.5,142000866,Adventure
2007,292000866,150000000,7.5,142000866,Family
2007,292000866,150000000,7.5,142000866,Fantasy
2007,292000866,150000000,7.5,142000866,Mystery
2007,256386216,150000000,7.2,106386216,Drama
2007,256386216,150000000,7.2,106386216,Horror
2007,256386216,150000000,7.2,106386216,Sci-Fi
2007,206435493,150000000,8,56435493,Animation
2007,206435493,150000000,8,56435493,Comedy
2007,206435493,150000000,8,56435493,Family
2007,206435493,150000000,8,56435493,Fantasy
2007,126597121,150000000,6.2,-23402879,Adventure
2007,126597121,150000000,6.2,-23402879,Animation
2007,126597121,150000000,6.2,-23402879,Comedy
2007,126597121,150000000,6.2,-23402879,Family
2007,82161969,150000000,6.3,-67838031,Action
2007,82161969,150000000,6.3,-67838031,Adventure
2007,82161969,150000000,6.3,-67838031,Animation
2007,82161969,150000000,6.3,-67838031,Fantasy
2007,227137090,110000000,8.1,117137090,Action
2007,227137090,110000000,8.1,117137090,Mystery
2007,227137090,110000000,8.1,117137090,Thriller
2007,131920333,130000000,5.6,1920333,Action
2007,131920333,130000000,5.6,1920333,Adventure
2007,131920333,130000000,5.6,1920333,Sci-Fi
2007,131920333,130000000,5.6,1920333,Thriller
2007,115802596,110000000,5.2,5802596,Action
2007,115802596,110000000,5.2,5802596,Fantasy
2007,115802596,110000000,5.2,5802596,Thriller
2007,134520804,110000000,7.2,24520804,Action
2007,134520804,110000000,7.2,24520804,Adventure
2007,134520804,110000000,7.2,24520804,Thriller
2007,130127620,100000000,7.8,30127620,Biography
2007,130127620,100000000,7.8,30127620,Crime
2007,130127620,100000000,7.8,30127620,Drama
2007,58867694,100000000,6.8,-41132306,Animation
2007,58867694,100000000,6.8,-41132306,Comedy
2007,58867694,100000000,6.8,-41132306,Family
2007,58867694,100000000,6.8,-41132306,Sport
2007,127706877,85000000,7.1,42706877,Animation
2007,127706877,85000000,7.1,42706877,Comedy
2007,127706877,85000000,7.1,42706877,Family
2007,127706877,85000000,7.1,42706877,Fantasy
2007,127706877,85000000,7.1,42706877,Musical
2007,127706877,85000000,7.1,42706877,Romance
2007,117144465,85000000,6.9,32144465,Crime
2007,117144465,85000000,6.9,32144465,Thriller
2007,33048353,65000000,7.7,-31951647,Crime
2007,33048353,65000000,7.7,-31951647,Drama
2007,33048353,65000000,7.7,-31951647,History
2007,33048353,65000000,7.7,-31951647,Mystery
2007,33048353,65000000,7.7,-31951647,Thriller
2007,15071514,80000000,5.9,-64928486,Sci-Fi
2007,15071514,80000000,5.9,-64928486,Thriller
2007,118823091,75000000,6.7,43823091,Comedy
2007,118823091,75000000,6.7,43823091,Drama
2007,118823091,75000000,6.7,43823091,Family
2007,118823091,75000000,6.7,43823091,Music
2007,118823091,75000000,6.7,43823091,Musical
2007,118823091,75000000,6.7,43823091,Romance
2007,66636385,75000000,7.1,-8363615,Biography
2007,66636385,75000000,7.1,-8363615,Comedy
2007,66636385,75000000,7.1,-8363615,Drama
2007,66636385,75000000,7.1,-8363615,History
2007,47456450,70000000,7.1,-22543550,Action
2007,47456450,70000000,7.1,-22543550,Drama
2007,47456450,70000000,7.1,-22543550,Thriller
2007,183132370,75000000,7.4,108132370,Adventure
2007,183132370,75000000,7.4,108132370,Animation
2007,183132370,75000000,7.4,108132370,Comedy
2007,38345403,70000000,7.7,-31654597,Adventure
2007,38345403,70000000,7.7,-31654597,Family
2007,38345403,70000000,7.7,-31654597,Fantasy
2007,38345403,70000000,7.7,-31654597,Romance
2007,5932060,35000000,5.4,-29067940,Action
2007,5932060,35000000,5.4,-29067940,Adventure
2007,5932060,35000000,5.4,-29067940,Fantasy
2007,5932060,35000000,5.4,-29067940,War
2007,118153533,61000000,6.3,57153533,Comedy
2007,118153533,61000000,6.3,57153533,Sport
2007,46975183,61000000,7.2,-14024817,Action
2007,46975183,61000000,7.2,-14024817,Crime
2007,46975183,61000000,7.2,-14024817,Drama
2007,46975183,61000000,7.2,-14024817,Mystery
2007,46975183,61000000,7.2,-14024817,Thriller
2007,4535117,60000000,3.8,-55464883,Action
2007,4535117,60000000,3.8,-55464883,Adventure
2007,4535117,60000000,3.8,-55464883,Fantasy
2007,4535117,60000000,3.8,-55464883,Thriller
2007,217326336,60000000,5.2,157326336,Animation
2007,217326336,60000000,5.2,157326336,Comedy
2007,217326336,60000000,5.2,157326336,Family
2007,217326336,60000000,5.2,157326336,Fantasy
2007,217326336,60000000,5.2,157326336,Music
2007,16264475,55000000,6.9,-38735525,Biography
2007,16264475,55000000,6.9,-38735525,Drama
2007,16264475,55000000,6.9,-38735525,History
2007,16264475,55000000,6.9,-38735525,War
2007,25031037,53000000,7.6,-27968963,Action
2007,25031037,53000000,7.6,-27968963,Horror
2007,25031037,53000000,7.6,-27968963,Thriller
2007,5755286,55000000,5.9,-49244714,Drama
2007,5755286,55000000,5.9,-49244714,Romance
2007,5755286,55000000,5.9,-49244714,Sport
2007,27667947,50000000,6.2,-22332053,Crime
2007,27667947,50000000,6.2,-22332053,Drama
2007,27667947,50000000,6.2,-22332053,Thriller
2007,17114882,25000000,7.7,-7885118,Crime
2007,17114882,25000000,7.7,-7885118,Mystery
2007,17114882,25000000,7.7,-7885118,Thriller
2007,53574088,55000000,7.8,-1425912,Adventure
2007,53574088,55000000,7.8,-1425912,Crime
2007,53574088,55000000,7.8,-1425912,Drama
2007,53574088,55000000,7.8,-1425912,Western
2007,93452056,45000000,7.4,48452056,Adventure
2007,93452056,45000000,7.4,48452056,Comedy
2007,93452056,45000000,7.4,48452056,Drama
2007,50648679,45000000,6.3,5648679,Action
2007,50648679,45000000,6.3,5648679,Horror
2007,50648679,45000000,6.3,5648679,Sci-Fi
2007,50648679,45000000,6.3,5648679,Thriller
2007,24343673,45000000,7.4,-20656327,Drama
2007,24343673,45000000,7.4,-20656327,Fantasy
2007,24343673,45000000,7.4,-20656327,Musical
2007,24343673,45000000,7.4,-20656327,Romance
2007,4584886,45000000,6.4,-40415114,Drama
2007,4584886,45000000,6.4,-40415114,Romance
2007,41797066,40000000,4.7,1797066,Action
2007,41797066,40000000,4.7,1797066,Horror
2007,41797066,40000000,4.7,1797066,Sci-Fi
2007,41797066,40000000,4.7,1797066,Thriller
2007,25117498,40000000,5.7,-14882502,Horror
2007,25117498,40000000,5.7,-14882502,Thriller
2007,3675072,26000000,7.3,-22324928,Adventure
2007,3675072,26000000,7.3,-22324928,Sci-Fi
2007,3675072,26000000,7.3,-22324928,Thriller
2007,80050171,20000000,6.9,60050171,Drama
2007,80050171,20000000,6.9,60050171,Mystery
2007,80050171,20000000,6.9,60050171,Thriller
2007,876671,25000000,6.9,-24123329,Adventure
2007,876671,25000000,6.9,-24123329,Comedy
2007,876671,25000000,6.9,-24123329,Drama
2007,876671,25000000,6.9,-24123329,Romance
2007,876671,25000000,6.9,-24123329,Thriller
2007,876671,25000000,6.9,-24123329,War
2007,128978,40000000,7.1,-39871022,Action
2007,128978,40000000,7.1,-39871022,Drama
2007,128978,40000000,7.1,-39871022,History
2007,128978,40000000,7.1,-39871022,Romance
2007,128978,40000000,7.1,-39871022,War
2007,54132596,34000000,6.3,20132596,Action
2007,54132596,34000000,6.3,20132596,Adventure
2007,54132596,34000000,6.3,20132596,Animation
2007,54132596,34000000,6.3,20132596,Comedy
2007,54132596,34000000,6.3,20132596,Family
2007,54132596,34000000,6.3,20132596,Fantasy
2007,54132596,34000000,6.3,20132596,Sci-Fi
2007,43792641,35000000,5.3,8792641,Comedy
2007,43792641,35000000,5.3,8792641,Romance
2007,14998070,35000000,6.2,-20001930,Drama
2007,14998070,35000000,6.2,-20001930,Thriller
2007,14998070,35000000,6.2,-20001930,War
2007,18317151,35000000,6.7,-16682849,Comedy
2007,18317151,35000000,6.7,-16682849,Music
2007,35063732,32000000,6.4,3063732,Mystery
2007,35063732,32000000,6.4,3063732,Thriller
2007,10956379,35000000,3.6,-24043621,Action
2007,10956379,35000000,3.6,-24043621,Drama
2007,10956379,35000000,3.6,-24043621,Fantasy
2007,10956379,35000000,3.6,-24043621,Horror
2007,10956379,35000000,3.6,-24043621,Thriller
2007,53680848,30000000,7.1,23680848,Drama
2007,53680848,30000000,7.1,23680848,Romance
2007,50921738,30000000,7.8,20921738,Drama
2007,50921738,30000000,7.8,20921738,Mystery
2007,50921738,30000000,7.8,20921738,Romance
2007,50921738,30000000,7.8,20921738,War
2007,39568996,32000000,6.6,7568996,Horror
2007,16930884,30000000,5.9,-13069116,Crime
2007,16930884,30000000,5.9,-13069116,Drama
2007,16930884,30000000,5.9,-13069116,Mystery
2007,16930884,30000000,5.9,-13069116,Thriller
2007,3904982,30000000,7.5,-26095018,Biography
2007,3904982,30000000,7.5,-26095018,Crime
2007,3904982,30000000,7.5,-26095018,Drama
2007,3904982,30000000,7.5,-26095018,History
2007,3904982,30000000,7.5,-26095018,Western
2007,43097652,28000000,6.3,15097652,Comedy
2007,43097652,28000000,6.3,15097652,Drama
2007,43097652,28000000,6.3,15097652,Romance
2007,28563179,21000000,6.9,7563179,Crime
2007,28563179,21000000,6.9,7563179,Drama
2007,28563179,21000000,6.9,7563179,Thriller
2007,148734225,30000000,7,118734225,Comedy
2007,148734225,30000000,7,118734225,Romance
2007,9664316,27500000,6.8,-17835684,Drama
2007,9664316,27500000,6.8,-17835684,Thriller
2007,7486906,27000000,6.8,-19513094,Comedy
2007,7486906,27000000,6.8,-19513094,Drama
2007,7486906,27000000,6.8,-19513094,Family
2007,74273505,25000000,8.1,49273505,Crime
2007,74273505,25000000,8.1,49273505,Drama
2007,74273505,25000000,8.1,49273505,Thriller
2007,82234139,17000000,7.2,65234139,Adventure
2007,82234139,17000000,7.2,65234139,Drama
2007,82234139,17000000,7.2,65234139,Family
2007,82234139,17000000,7.2,65234139,Fantasy
2007,40218903,25000000,8.1,15218903,Drama
2007,35000629,25000000,5.6,10000629,Comedy
2007,35000629,25000000,5.6,10000629,Romance
2007,32553210,25000000,6.3,7553210,Comedy
2007,32553210,25000000,6.3,7553210,Family
2007,31655091,30000000,7.5,1655091,Drama
2007,31655091,30000000,7.5,1655091,Music
2007,22466994,25000000,6.3,-2533006,Action
2007,22466994,25000000,6.3,-2533006,Crime
2007,22466994,25000000,6.3,-2533006,Thriller
2007,71975611,25000000,6.8,46975611,Fantasy
2007,71975611,25000000,6.8,46975611,Horror
2007,90636983,22000000,6.2,68636983,Comedy
2007,90636983,22000000,6.2,68636983,Family
2007,90636983,22000000,6.2,68636983,Sport
2007,634277,16000000,7.3,-15365723,Comedy
2007,634277,16000000,7.3,-15365723,History
2007,49024969,25000000,7.3,24024969,Crime
2007,49024969,25000000,7.3,24024969,Drama
2007,49024969,25000000,7.3,24024969,Mystery
2007,49024969,25000000,7.3,24024969,Thriller
2007,8579684,9000000,7.4,-420316,Comedy
2007,36581633,21000000,7.5,15581633,Biography
2007,36581633,21000000,7.5,15581633,Crime
2007,36581633,21000000,7.5,15581633,Drama
2007,80050171,20000000,6.9,60050171,Drama
2007,80050171,20000000,6.9,60050171,Mystery
2007,80050171,20000000,6.9,60050171,Thriller
2007,47852604,20000000,5.9,27852604,Drama
2007,47852604,20000000,5.9,27852604,Mystery
2007,47852604,20000000,5.9,27852604,Thriller
2007,39737645,20000000,2.3,19737645,Adventure
2007,39737645,20000000,2.3,19737645,Comedy
2007,25584685,20000000,5.9,5584685,Comedy
2007,25584685,20000000,5.9,5584685,Crime
2007,25584685,20000000,5.9,5584685,Family
2007,25584685,20000000,5.9,5584685,Mystery
2007,25584685,20000000,5.9,5584685,Romance
2007,25584685,20000000,5.9,5584685,Thriller
2007,18882880,20000000,5.9,-1117120,Comedy
2007,18882880,20000000,5.9,-1117120,Drama
2007,19661987,20000000,7.5,-338013,Drama
2007,18352454,15000000,8.2,3352454,Adventure
2007,18352454,15000000,8.2,3352454,Biography
2007,18352454,15000000,8.2,3352454,Drama
2007,15797907,20000000,7.6,-4202093,Drama
2007,8579684,9000000,7.4,-420316,Comedy
2007,9525276,20000000,6.8,-10474724,Action
2007,9525276,20000000,6.8,-10474724,Crime
2007,9525276,20000000,6.8,-10474724,Thriller
2007,8104069,20000000,4.5,-11895931,Action
2007,8104069,20000000,4.5,-11895931,Comedy
2007,8104069,20000000,4.5,-11895931,Crime
2007,4001121,20000000,7,-15998879,Biography
2007,4001121,20000000,7,-15998879,Drama
2007,4001121,20000000,7,-15998879,Music
2007,5701643,20000000,7.3,-14298357,Adventure
2007,5701643,20000000,7.3,-14298357,Biography
2007,5701643,20000000,7.3,-14298357,Drama
2007,5701643,20000000,7.3,-14298357,History
2007,5701643,20000000,7.3,-14298357,War
2007,121463226,20000000,7.6,101463226,Comedy
2007,39687528,24000000,6.3,15687528,Action
2007,39687528,24000000,6.3,15687528,Crime
2007,39687528,24000000,6.3,15687528,Drama
2007,39687528,24000000,6.3,15687528,Thriller
2007,18663911,16500000,7.1,2163911,Biography
2007,18663911,16500000,7.1,2163911,Drama
2007,18663911,16500000,7.1,2163911,Romance
2007,11702090,16500000,6.3,-4797910,Comedy
2007,11702090,16500000,6.3,-4797910,Romance
2007,23618786,8000000,7.9,15618786,Action
2007,23618786,8000000,7.9,15618786,Comedy
2007,23618786,8000000,7.9,15618786,Mystery
2007,2849142,16000000,7.2,-13150858,Drama
2007,55184721,15000000,5.6,40184721,Comedy
2007,55184721,15000000,5.6,40184721,Drama
2007,30226144,15000000,7.6,15226144,Biography
2007,30226144,15000000,7.6,15226144,Drama
2007,28637507,15000000,7,13637507,Drama
2007,28637507,15000000,7,13637507,Horror
2007,28637507,15000000,7,13637507,Sci-Fi
2007,20801344,15000000,5.1,5801344,Horror
2007,9172810,16000000,6.7,-6827190,Biography
2007,9172810,16000000,6.7,-6827190,Drama
2007,9172810,16000000,6.7,-6827190,History
2007,9172810,16000000,6.7,-6827190,Thriller
2007,9172810,16000000,6.7,-6827190,War
2007,1294640,15000000,6.5,-13705360,Crime
2007,1294640,15000000,6.5,-13705360,Drama
2007,1294640,15000000,6.5,-13705360,Horror
2007,1294640,15000000,6.5,-13705360,Thriller
2007,20380,15000000,5.9,-14979620,Comedy
2007,20380,15000000,5.9,-14979620,Drama
2007,20380,15000000,5.9,-14979620,Fantasy
2007,20380,15000000,5.9,-14979620,Music
2007,20380,15000000,5.9,-14979620,Romance
2007,61356221,14000000,5.2,47356221,Drama
2007,61356221,14000000,5.2,47356221,Music
2007,61356221,14000000,5.2,47356221,Romance
2007,49121934,13000000,6.1,36121934,Comedy
2007,49121934,13000000,6.1,36121934,Drama
2007,49121934,13000000,6.1,36121934,Romance
2007,25592632,18000000,7.2,7592632,Horror
2007,3169424,13000000,6.8,-9830576,Drama
2007,3169424,13000000,6.8,-9830576,Sport
2007,5949693,12000000,7.4,-6050307,Comedy
2007,5949693,12000000,7.4,-6050307,Drama
2007,5949693,12000000,7.4,-6050307,Romance
2007,3950294,12000000,7,-8049706,Comedy
2007,3950294,12000000,7,-8049706,Drama
2007,3950294,12000000,7,-8049706,Romance
2007,1506998,12000000,6.3,-10493002,Crime
2007,1506998,12000000,6.3,-10493002,Drama
2007,1506998,12000000,6.3,-10493002,Romance
2007,303439,8000000,6.4,-7696561,Drama
2007,303439,8000000,6.4,-7696561,Mystery
2007,303439,8000000,6.4,-7696561,Thriller
2007,214202,12000000,7.5,-11785798,Crime
2007,214202,12000000,7.5,-11785798,Drama
2007,214202,12000000,7.5,-11785798,Thriller
2007,11043445,10000000,6.5,1043445,Comedy
2007,11043445,10000000,6.5,1043445,Drama
2007,11043445,10000000,6.5,1043445,Romance
2007,1066555,11000000,5.8,-9933445,Drama
2007,1066555,11000000,5.8,-9933445,History
2007,1066555,11000000,5.8,-9933445,Romance
2007,1066555,11000000,5.8,-9933445,Western
2007,63270259,10000000,5.9,53270259,Horror
2007,63270259,10000000,5.9,53270259,Mystery
2007,20339754,10000000,5.9,10339754,Comedy
2007,20339754,10000000,5.9,10339754,Crime
2007,900926,10000000,5.3,-9099074,Comedy
2007,866778,10000000,6.7,-9133222,Drama
2007,866778,10000000,6.7,-9133222,Romance
2007,5561,10000000,3.9,-9994439,Comedy
2007,5561,10000000,3.9,-9994439,Romance
2007,24530513,9000000,8,15530513,Documentary
2007,24530513,9000000,8,15530513,Drama
2007,2955039,9000000,6.2,-6044961,Biography
2007,2955039,9000000,6.2,-6044961,Drama
2007,2955039,9000000,6.2,-6044961,Sport
2007,14373825,8600000,6.5,5773825,Crime
2007,14373825,8600000,6.5,5773825,Mystery
2007,14373825,8600000,6.5,5773825,Thriller
2007,1071240,8000000,6.9,-6928760,Biography
2007,1071240,8000000,6.9,-6928760,Drama
2007,398420,8000000,6.4,-7601580,Crime
2007,398420,8000000,6.4,-7601580,Drama
2007,17544812,10000000,5.4,7544812,Horror
2007,872643,6000000,5.4,-5127357,Comedy
2007,872643,6000000,5.4,-5127357,Family
2007,872643,6000000,5.4,-5127357,Romance
2007,4443403,7300000,8,-2856597,Animation
2007,4443403,7300000,8,-2856597,Biography
2007,4443403,7300000,8,-2856597,Drama
2007,4443403,7300000,8,-2856597,War
2007,336530303,258000000,6.2,78530303,Action
2007,336530303,258000000,6.2,78530303,Adventure
2007,336530303,258000000,6.2,78530303,Romance
2007,143492840,7500000,7.5,135992840,Comedy
2007,143492840,7500000,7.5,135992840,Drama
2007,143492840,7500000,7.5,135992840,Romance
2007,5694308,7000000,2,-1305692,Comedy
2007,5694308,7000000,2,-1305692,Sport
2007,8060,4000000,8.1,-3991940,Action
2007,8060,4000000,8.1,-3991940,Crime
2007,8060,4000000,8.1,-3991940,Drama
2007,8060,4000000,8.1,-3991940,Thriller
2007,871577,4500000,7.7,-3628423,Biography
2007,871577,4500000,7.7,-3628423,Drama
2007,871577,4500000,7.7,-3628423,Music
2007,13235267,6000000,2.9,7235267,Comedy
2007,13235267,6000000,2.9,7235267,Family
2007,766487,5250000,5,-4483513,Comedy
2007,766487,5250000,5,-4483513,Romance
2007,65087,5000000,6.2,-4934913,Crime
2007,65087,5000000,6.2,-4934913,Thriller
2007,65087,5000000,6.2,-4934913,War
2007,434417,4600000,5.9,-4165583,Drama
2007,7159147,3400000,7.5,3759147,Drama
2007,7159147,3400000,7.5,3759147,Mystery
2007,7159147,3400000,7.5,3759147,Thriller
2007,2426851,4000000,6.5,-1573149,Comedy
2007,2426851,4000000,6.5,-1573149,Crime
2007,2426851,4000000,6.5,-1573149,Romance
2007,2426851,4000000,6.5,-1573149,Thriller
2007,952620,2000000,5.7,-1047380,Horror
2007,38108,2600000,7.2,-2561892,Horror
2007,38108,2600000,7.2,-2561892,Mystery
2007,38108,2600000,7.2,-2561892,Sci-Fi
2007,38108,2600000,7.2,-2561892,Thriller
2007,379643,2200000,5.9,-1820357,Drama
2007,1430185,2000000,8.3,-569815,Documentary
2007,1430185,2000000,8.3,-569815,War
2007,1134049,2000000,8.1,-865951,Documentary
2007,1134049,2000000,8.1,-865951,History
2007,1060591,1300000,7.2,-239409,Comedy
2007,1060591,1300000,7.2,-239409,Drama
2007,1060591,1300000,7.2,-239409,Romance
2007,19067631,2000000,7.1,17067631,Comedy
2007,19067631,2000000,7.1,17067631,Drama
2007,19067631,2000000,7.1,17067631,Romance
2007,173066,1500000,6.3,-1326934,Comedy
2007,173066,1500000,6.3,-1326934,Fantasy
2007,7826,1200000,6.2,-1192174,Comedy
2007,7826,1200000,6.2,-1192174,Documentary
2007,143492840,7500000,7.5,135992840,Comedy
2007,143492840,7500000,7.5,135992840,Drama
2007,143492840,7500000,7.5,135992840,Romance
2007,274661,1000000,7.7,-725339,Crime
2007,274661,1000000,7.7,-725339,Documentary
2007,274661,1000000,7.7,-725339,War
2007,1185783,590000,7.9,595783,Drama
2007,442638,850000,7.3,-407362,Comedy
2007,442638,850000,7.3,-407362,Romance
2007,442638,850000,7.3,-407362,Sport
2007,5518918,750000,6.9,4768918,Action
2007,5518918,750000,6.9,4768918,Adventure
2007,5518918,750000,6.9,4768918,Animation
2007,5518918,750000,6.9,4768918,Comedy
2007,5518918,750000,6.9,4768918,Fantasy
2007,5518918,750000,6.9,4768918,Sci-Fi
2007,23616,600000,5.6,-576384,Mystery
2007,23616,600000,5.6,-576384,Thriller
2007,52850,500000,6.2,-447150,Comedy
2007,31937,500000,5.7,-468063,Comedy
2007,31937,500000,5.7,-468063,Romance
2007,12055,500000,6.5,-487945,Comedy
2007,107917283,15000,6.3,107902283,Horror
2007,24343673,45000000,7.4,-20656327,Drama
2007,24343673,45000000,7.4,-20656327,Fantasy
2007,24343673,45000000,7.4,-20656327,Musical
2007,24343673,45000000,7.4,-20656327,Romance
2007,9437933,180000,7.9,9257933,Drama
2007,9437933,180000,7.9,9257933,Music
2007,9437933,180000,7.9,9257933,Romance
2007,243768,30000,4.1,213768,Western
2006,200069408,209000000,6.1,-8930592,Action
2006,200069408,209000000,6.1,-8930592,Adventure
2006,200069408,209000000,6.1,-8930592,Sci-Fi
2006,423032628,225000000,7.3,198032628,Action
2006,423032628,225000000,7.3,198032628,Adventure
2006,423032628,225000000,7.3,198032628,Fantasy
2006,234360014,210000000,6.8,24360014,Action
2006,234360014,210000000,6.8,24360014,Adventure
2006,234360014,210000000,6.8,24360014,Fantasy
2006,234360014,210000000,6.8,24360014,Sci-Fi
2006,234360014,210000000,6.8,24360014,Thriller
2006,60655503,160000000,5.6,-99344497,Action
2006,60655503,160000000,5.6,-99344497,Adventure
2006,60655503,160000000,5.6,-99344497,Drama
2006,60655503,160000000,5.6,-99344497,Thriller
2006,133382309,150000000,6.9,-16617691,Action
2006,133382309,150000000,6.9,-16617691,Adventure
2006,133382309,150000000,6.9,-16617691,Thriller
2006,64459316,149000000,6.7,-84540684,Adventure
2006,64459316,149000000,6.7,-84540684,Animation
2006,64459316,149000000,6.7,-84540684,Comedy
2006,64459316,149000000,6.7,-84540684,Family
2006,217536138,125000000,6.6,92536138,Mystery
2006,217536138,125000000,6.6,92536138,Thriller
2006,250863268,110000000,6.4,140863268,Action
2006,250863268,110000000,6.4,140863268,Adventure
2006,250863268,110000000,6.4,140863268,Comedy
2006,250863268,110000000,6.4,140863268,Family
2006,250863268,110000000,6.4,140863268,Fantasy
2006,167007184,150000000,8,17007184,Action
2006,167007184,150000000,8,17007184,Adventure
2006,167007184,150000000,8,17007184,Thriller
2006,75030163,100000000,5.1,-24969837,Action
2006,75030163,100000000,5.1,-24969837,Adventure
2006,75030163,100000000,5.1,-24969837,Family
2006,75030163,100000000,5.1,-24969837,Fantasy
2006,57366262,100000000,8,-42633738,Adventure
2006,57366262,100000000,8,-42633738,Drama
2006,57366262,100000000,8,-42633738,Thriller
2006,132373442,90000000,8.5,42373442,Crime
2006,132373442,90000000,8.5,42373442,Drama
2006,132373442,90000000,8.5,42373442,Thriller
2006,197992827,100000000,6.5,97992827,Animation
2006,197992827,100000000,6.5,97992827,Comedy
2006,197992827,100000000,6.5,97992827,Family
2006,197992827,100000000,6.5,97992827,Music
2006,197992827,100000000,6.5,97992827,Romance
2006,63224849,85000000,6.9,-21775151,Comedy
2006,63224849,85000000,6.9,-21775151,Romance
2006,84303558,85000000,6.2,-696442,Adventure
2006,84303558,85000000,6.2,-696442,Animation
2006,84303558,85000000,6.2,-696442,Comedy
2006,84303558,85000000,6.2,-696442,Family
2006,62494975,85000000,6,-22505025,Action
2006,62494975,85000000,6,-22505025,Crime
2006,62494975,85000000,6,-22505025,Thriller
2006,137340146,70000000,6.4,67340146,Comedy
2006,137340146,70000000,6.4,67340146,Drama
2006,137340146,70000000,6.4,67340146,Fantasy
2006,137340146,70000000,6.4,67340146,Romance
2006,155019340,80000000,6.8,75019340,Adventure
2006,155019340,80000000,6.8,75019340,Animation
2006,155019340,80000000,6.8,75019340,Comedy
2006,155019340,80000000,6.8,75019340,Family
2006,82226474,65000000,5.6,17226474,Adventure
2006,82226474,65000000,5.6,17226474,Comedy
2006,82226474,65000000,5.6,17226474,Crime
2006,82226474,65000000,5.6,17226474,Family
2006,82226474,65000000,5.6,17226474,Mystery
2006,15131330,86000000,6,-70868670,Adventure
2006,15131330,86000000,6,-70868670,Animation
2006,15131330,86000000,6,-70868670,Family
2006,15131330,86000000,6,-70868670,Fantasy
2006,35286428,76000000,7.9,-40713572,Drama
2006,35286428,76000000,7.9,-40713572,Sci-Fi
2006,35286428,76000000,7.9,-40713572,Thriller
2006,195329763,80000000,6.9,115329763,Action
2006,195329763,80000000,6.9,115329763,Adventure
2006,195329763,80000000,6.9,115329763,Animation
2006,195329763,80000000,6.9,115329763,Comedy
2006,195329763,80000000,6.9,115329763,Family
2006,195329763,80000000,6.9,115329763,Fantasy
2006,103338338,70000000,6.5,33338338,Drama
2006,103338338,70000000,6.5,33338338,Music
2006,103338338,70000000,6.5,33338338,Musical
2006,73661010,75000000,6.6,-1338990,Animation
2006,73661010,75000000,6.6,-1338990,Comedy
2006,73661010,75000000,6.6,-1338990,Family
2006,73661010,75000000,6.6,-1338990,Fantasy
2006,73661010,75000000,6.6,-1338990,Mystery
2006,148213377,73000000,6.6,75213377,Action
2006,148213377,73000000,6.6,75213377,Comedy
2006,148213377,73000000,6.6,75213377,Sport
2006,244052771,120000000,7.2,124052771,Adventure
2006,244052771,120000000,7.2,124052771,Animation
2006,244052771,120000000,7.2,124052771,Comedy
2006,244052771,120000000,7.2,124052771,Family
2006,244052771,120000000,7.2,124052771,Sport
2006,42272747,70000000,5.6,-27727253,Drama
2006,42272747,70000000,5.6,-27727253,Fantasy
2006,42272747,70000000,5.6,-27727253,Mystery
2006,42272747,70000000,5.6,-27727253,Thriller
2006,5851188,70000000,4.2,-64148812,Crime
2006,5851188,70000000,4.2,-64148812,Mystery
2006,5851188,70000000,4.2,-64148812,Thriller
2006,70236496,63000000,6,7236496,Drama
2006,70236496,63000000,6,7236496,History
2006,70236496,63000000,6,7236496,Thriller
2006,43532294,65000000,7.1,-21467706,Drama
2006,43532294,65000000,7.1,-21467706,Sport
2006,2208939,50000000,7.5,-47791061,Crime
2006,2208939,50000000,7.5,-47791061,Drama
2006,2208939,50000000,7.5,-47791061,Fantasy
2006,58255287,64000000,4.3,-5744713,Comedy
2006,58255287,64000000,4.3,-5744713,Crime
2006,210592590,65000000,7.7,145592590,Action
2006,210592590,65000000,7.7,145592590,Drama
2006,210592590,65000000,7.7,145592590,Fantasy
2006,210592590,65000000,7.7,145592590,War
2006,61112916,50000000,4.4,11112916,Comedy
2006,61112916,50000000,4.4,11112916,Family
2006,61112916,50000000,4.4,11112916,Fantasy
2006,36279230,60000000,6.1,-23720770,Action
2006,36279230,60000000,6.1,-23720770,Crime
2006,36279230,60000000,6.1,-23720770,Thriller
2006,22518325,50000000,5.6,-27481675,Crime
2006,22518325,50000000,5.6,-27481675,Drama
2006,22518325,50000000,5.6,-27481675,Mystery
2006,22518325,50000000,5.6,-27481675,Thriller
2006,13082288,60000000,6.6,-46917712,Action
2006,13082288,60000000,6.6,-46917712,Adventure
2006,13082288,60000000,6.6,-46917712,Drama
2006,13082288,60000000,6.6,-46917712,History
2006,13082288,60000000,6.6,-46917712,Romance
2006,13082288,60000000,6.6,-46917712,War
2006,162586036,55000000,8,107586036,Biography
2006,162586036,55000000,8,107586036,Drama
2006,75604320,54000000,5.6,21604320,Comedy
2006,75604320,54000000,5.6,21604320,Romance
2006,7221458,55000000,6.2,-47778542,Drama
2006,7221458,55000000,6.2,-47778542,Thriller
2006,33574332,90000000,7.1,-56425668,Drama
2006,33574332,90000000,7.1,-56425668,History
2006,33574332,90000000,7.1,-56425668,War
2006,118683135,52000000,5.8,66683135,Comedy
2006,118683135,52000000,5.8,66683135,Drama
2006,118683135,52000000,5.8,66683135,Romance
2006,72601713,51000000,5.6,21601713,Animation
2006,72601713,51000000,5.6,21601713,Comedy
2006,72601713,51000000,5.6,21601713,Family
2006,88504640,45000000,7.6,43504640,Crime
2006,88504640,45000000,7.6,43504640,Drama
2006,88504640,45000000,7.6,43504640,Mystery
2006,88504640,45000000,7.6,43504640,Thriller
2006,88658172,50000000,5.6,38658172,Comedy
2006,88658172,50000000,5.6,38658172,Romance
2006,58336565,50000000,6.6,8336565,Adventure
2006,58336565,50000000,6.6,8336565,Animation
2006,58336565,50000000,6.6,8336565,Comedy
2006,58336565,50000000,6.6,8336565,Family
2006,48745150,50000000,5.8,-1254850,Crime
2006,48745150,50000000,5.8,-1254850,Thriller
2006,46982632,50000000,6.6,-3017368,Adventure
2006,46982632,50000000,6.6,-3017368,Horror
2006,46982632,50000000,6.6,-3017368,Mystery
2006,15519841,47000000,4.5,-31480159,Adventure
2006,15519841,47000000,4.5,-31480159,Animation
2006,15519841,47000000,4.5,-31480159,Comedy
2006,15519841,47000000,4.5,-31480159,Family
2006,15519841,47000000,4.5,-31480159,Fantasy
2006,38360195,45000000,6.4,-6639805,Adventure
2006,38360195,45000000,6.4,-6639805,Comedy
2006,38360195,45000000,6.4,-6639805,Drama
2006,28133159,50000000,5.9,-21866841,Adventure
2006,28133159,50000000,5.9,-21866841,Animation
2006,28133159,50000000,5.9,-21866841,Comedy
2006,28133159,50000000,5.9,-21866841,Family
2006,28133159,50000000,5.9,-21866841,Fantasy
2006,36883539,52000000,6.6,-15116461,Action
2006,36883539,52000000,6.6,-15116461,Crime
2006,36883539,52000000,6.6,-15116461,Drama
2006,36883539,52000000,6.6,-15116461,Thriller
2006,6565495,45000000,7,-38434505,Drama
2006,6565495,45000000,7,-38434505,Romance
2006,62318875,50000000,6.8,12318875,Action
2006,62318875,50000000,6.8,12318875,Adventure
2006,62318875,50000000,6.8,12318875,Fantasy
2006,62318875,50000000,6.8,12318875,Sci-Fi
2006,62318875,50000000,6.8,12318875,Thriller
2006,90703745,45000000,5.1,45703745,Comedy
2006,81593527,40000000,7.3,41593527,Adventure
2006,81593527,40000000,7.3,41593527,Drama
2006,81593527,40000000,7.3,41593527,Family
2006,70163652,40000000,4.6,30163652,Comedy
2006,70163652,40000000,4.6,30163652,Crime
2006,53082743,40000000,8.5,13082743,Drama
2006,53082743,40000000,8.5,13082743,Mystery
2006,53082743,40000000,8.5,13082743,Sci-Fi
2006,53082743,40000000,8.5,13082743,Thriller
2006,50859889,40000000,7.8,10859889,Action
2006,50859889,40000000,7.8,10859889,Adventure
2006,50859889,40000000,7.8,10859889,Drama
2006,50859889,40000000,7.8,10859889,Thriller
2006,52320979,40000000,6.8,12320979,Drama
2006,52320979,40000000,6.8,12320979,Fantasy
2006,52320979,40000000,6.8,12320979,Romance
2006,15962471,40000000,6.4,-24037529,Biography
2006,15962471,40000000,6.4,-24037529,Drama
2006,15962471,40000000,6.4,-24037529,History
2006,15962471,40000000,6.4,-24037529,Romance
2006,652526,40000000,5.1,-39347474,Action
2006,652526,40000000,5.1,-39347474,Adventure
2006,652526,40000000,5.1,-39347474,Family
2006,652526,40000000,5.1,-39347474,Thriller
2006,124732962,35000000,6.8,89732962,Comedy
2006,124732962,35000000,6.8,89732962,Drama
2006,124732962,35000000,6.8,89732962,Romance
2006,57651794,33000000,5.6,24651794,Comedy
2006,57651794,33000000,5.6,24651794,Romance
2006,57651794,33000000,5.6,24651794,Sport
2006,37617947,30000000,6.8,7617947,Drama
2006,37617947,30000000,6.8,7617947,Family
2006,37617947,30000000,6.8,7617947,Fantasy
2006,11631245,35000000,4.2,-23368755,Action
2006,11631245,35000000,4.2,-23368755,Adventure
2006,11631245,35000000,4.2,-23368755,Family
2006,11631245,35000000,4.2,-23368755,Sci-Fi
2006,7458269,35000000,6.9,-27541731,Comedy
2006,7458269,35000000,6.9,-27541731,Drama
2006,7458269,35000000,6.9,-27541731,Romance
2006,10139254,35000000,7.3,-24860746,Drama
2006,10139254,35000000,7.3,-24860746,Sci-Fi
2006,34014398,33000000,5.6,1014398,Action
2006,34014398,33000000,5.6,1014398,Adventure
2006,34014398,33000000,5.6,1014398,Crime
2006,34014398,33000000,5.6,1014398,Drama
2006,34014398,33000000,5.6,1014398,Thriller
2006,80197993,32000000,5.7,48197993,Comedy
2006,80197993,32000000,5.7,48197993,Family
2006,80197993,32000000,5.7,48197993,Sport
2006,1304837,32000000,6.1,-30695163,Drama
2006,1304837,32000000,6.1,-30695163,Mystery
2006,1304837,32000000,6.1,-30695163,Thriller
2006,40137776,38000000,7.6,2137776,Comedy
2006,40137776,38000000,7.6,2137776,Drama
2006,40137776,38000000,7.6,2137776,Fantasy
2006,40137776,38000000,7.6,2137776,Romance
2006,34703228,30000000,6.7,4703228,Drama
2006,34703228,30000000,6.7,4703228,Music
2006,38432823,30000000,6.9,8432823,Crime
2006,38432823,30000000,6.9,8432823,Drama
2006,38432823,30000000,6.9,8432823,Sport
2006,22526144,30000000,5.1,-7473856,Comedy
2006,22526144,30000000,5.1,-7473856,Romance
2006,22526144,30000000,5.1,-7473856,Sci-Fi
2006,18500966,30000000,4.4,-11499034,Action
2006,18500966,30000000,4.4,-11499034,Horror
2006,18500966,30000000,4.4,-11499034,Sci-Fi
2006,18500966,30000000,4.4,-11499034,Thriller
2006,2975649,30000000,7,-27024351,Biography
2006,2975649,30000000,7,-27024351,Drama
2006,2975649,30000000,7,-27024351,Romance
2006,480314,21000000,4.8,-20519686,Action
2006,480314,21000000,4.8,-20519686,Adventure
2006,17324744,28000000,5.3,-10675256,Comedy
2006,17324744,28000000,5.3,-10675256,Fantasy
2006,17324744,28000000,5.3,-10675256,Romance
2006,17508670,15000000,7.4,2508670,Crime
2006,17508670,15000000,7.4,2508670,Drama
2006,17508670,15000000,7.4,2508670,Romance
2006,17508670,15000000,7.4,2508670,Thriller
2006,22494487,27000000,7.8,-4505513,Crime
2006,22494487,27000000,7.8,-4505513,Drama
2006,22494487,27000000,7.8,-4505513,Mystery
2006,22494487,27000000,7.8,-4505513,Thriller
2006,54098051,25000000,5.8,29098051,Horror
2006,33687630,20000000,6.4,13687630,Comedy
2006,33687630,20000000,6.4,13687630,Romance
2006,16647384,26000000,5.1,-9352616,Adventure
2006,16647384,26000000,5.1,-9352616,Comedy
2006,16647384,26000000,5.1,-9352616,Family
2006,16647384,26000000,5.1,-9352616,Romance
2006,7156933,25000000,6.7,-17843067,Comedy
2006,7156933,25000000,6.7,-17843067,Drama
2006,34014398,33000000,5.6,1014398,Action
2006,34014398,33000000,5.6,1014398,Adventure
2006,34014398,33000000,5.6,1014398,Crime
2006,34014398,33000000,5.6,1014398,Drama
2006,34014398,33000000,5.6,1014398,Thriller
2006,70269171,24000000,7.2,46269171,Drama
2006,70269171,24000000,7.2,46269171,Sport
2006,4398392,21000000,7.8,-16601608,Drama
2006,4398392,21000000,7.8,-16601608,Thriller
2006,4398392,21000000,7.8,-16601608,War
2006,20259297,20000000,4.7,259297,Drama
2006,20259297,20000000,4.7,259297,Horror
2006,20259297,20000000,4.7,259297,Sci-Fi
2006,20259297,20000000,4.7,259297,Thriller
2006,48546578,20000000,2.7,28546578,Comedy
2006,48546578,20000000,2.7,28546578,Romance
2006,39143839,20000000,5,19143839,Horror
2006,39143839,20000000,5,19143839,Thriller
2006,37442180,20000000,6.2,17442180,Comedy
2006,37442180,20000000,6.2,17442180,Drama
2006,37442180,20000000,6.2,17442180,Romance
2006,37442180,20000000,6.2,17442180,Thriller
2006,34300771,25000000,7.5,9300771,Drama
2006,23078294,9000000,5.1,14078294,Horror
2006,23078294,9000000,5.1,14078294,Thriller
2006,23292105,20000000,5.3,3292105,Action
2006,23292105,20000000,5.3,3292105,Fantasy
2006,23292105,20000000,5.3,3292105,Horror
2006,23292105,20000000,5.3,3292105,Thriller
2006,17803796,20000000,5.9,-2196204,Comedy
2006,13391174,20000000,6.3,-6608826,Biography
2006,13391174,20000000,6.3,-6608826,Drama
2006,13391174,20000000,6.3,-6608826,History
2006,7382993,20000000,2.8,-12617007,Adventure
2006,7382993,20000000,2.8,-12617007,Animation
2006,7382993,20000000,2.8,-12617007,Comedy
2006,7382993,20000000,2.8,-12617007,Family
2006,7382993,20000000,2.8,-12617007,Fantasy
2006,5480996,8700000,7.1,-3219004,Animation
2006,5480996,8700000,7.1,-3219004,Drama
2006,5480996,8700000,7.1,-3219004,Mystery
2006,5480996,8700000,7.1,-3219004,Sci-Fi
2006,5480996,8700000,7.1,-3219004,Thriller
2006,8047690,19400000,7.5,-11352310,Drama
2006,8047690,19400000,7.5,-11352310,Romance
2006,128505958,18000000,7.3,110505958,Comedy
2006,31471430,15000000,7.6,16471430,Drama
2006,31471430,15000000,7.6,16471430,History
2006,31471430,15000000,7.6,16471430,Thriller
2006,63260,14000000,6.7,-13936740,Action
2006,63260,14000000,6.7,-13936740,Animation
2006,63260,14000000,6.7,-13936740,Sci-Fi
2006,63260,14000000,6.7,-13936740,Thriller
2006,19179969,17500000,6.3,1679969,Comedy
2006,35635046,17000000,6.7,18635046,Action
2006,35635046,17000000,6.7,18635046,Crime
2006,35635046,17000000,6.7,18635046,Drama
2006,35635046,17000000,6.7,18635046,Thriller
2006,41777564,15000000,6.4,26777564,Horror
2006,15655665,4000000,3.1,11655665,Comedy
2006,15655665,4000000,3.1,11655665,Romance
2006,7156725,19000000,5.5,-11843275,Comedy
2006,7156725,19000000,5.5,-11843275,Music
2006,6855137,17000000,7.4,-10144863,Action
2006,6855137,17000000,7.4,-10144863,Crime
2006,6855137,17000000,7.4,-10144863,Drama
2006,6855137,17000000,7.4,-10144863,Thriller
2006,39825798,16000000,7.6,23825798,Drama
2006,39825798,16000000,7.6,23825798,Mystery
2006,39825798,16000000,7.6,23825798,Romance
2006,39825798,16000000,7.6,23825798,Thriller
2006,273420,17000000,5.5,-16726580,Comedy
2006,273420,17000000,5.5,-16726580,Mystery
2006,273420,17000000,5.5,-16726580,Sci-Fi
2006,273420,17000000,5.5,-16726580,Thriller
2006,220914,16800000,6.5,-16579086,Biography
2006,220914,16800000,6.5,-16579086,Drama
2006,220914,16800000,6.5,-16579086,Romance
2006,39825798,16000000,7.6,23825798,Drama
2006,39825798,16000000,7.6,23825798,Mystery
2006,39825798,16000000,7.6,23825798,Romance
2006,39825798,16000000,7.6,23825798,Thriller
2006,39511038,16000000,5.9,23511038,Horror
2006,37623143,13500000,8.2,24123143,Drama
2006,37623143,13500000,8.2,24123143,Fantasy
2006,37623143,13500000,8.2,24123143,War
2006,7774730,15500000,6.5,-7725270,Comedy
2006,7774730,15500000,6.5,-7725270,Horror
2006,7774730,15500000,6.5,-7725270,Sci-Fi
2006,56437947,9800000,7.3,46637947,Biography
2006,56437947,9800000,7.3,46637947,Drama
2006,47860214,15000000,5,32860214,Horror
2006,47860214,15000000,5,32860214,Thriller
2006,20998709,15000000,6.2,5998709,Adventure
2006,20998709,15000000,6.2,5998709,Drama
2006,20998709,15000000,6.2,5998709,Family
2006,18843314,20000000,4.7,-1156686,Action
2006,18843314,20000000,4.7,-1156686,Drama
2006,18843314,20000000,4.7,-1156686,Thriller
2006,12549485,15000000,6.2,-2450515,Crime
2006,12549485,15000000,6.2,-2450515,Drama
2006,12549485,15000000,6.2,-2450515,Musical
2006,12549485,15000000,6.2,-2450515,Romance
2006,9396487,15000000,7,-5603513,Drama
2006,9396487,15000000,7,-5603513,Music
2006,8080116,15000000,5.6,-6919884,Adventure
2006,8080116,15000000,5.6,-6919884,Comedy
2006,8080116,15000000,5.6,-6919884,Family
2006,11204499,14000000,7,-2795501,Drama
2006,11204499,14000000,7,-2795501,History
2006,5459824,26000000,7.6,-20540176,Drama
2006,5459824,26000000,7.6,-20540176,Romance
2006,4291965,14000000,6.7,-9708035,Biography
2006,4291965,14000000,6.7,-9708035,Drama
2006,4291965,14000000,6.7,-9708035,History
2006,13753931,19000000,7.9,-5246069,Drama
2006,13753931,19000000,7.9,-5246069,History
2006,13753931,19000000,7.9,-5246069,War
2006,10996440,13000000,6.3,-2003560,Adventure
2006,10996440,13000000,6.3,-2003560,Drama
2006,10996440,13000000,6.3,-2003560,Sci-Fi
2006,4857376,13000000,7.3,-8142624,Comedy
2006,4857376,13000000,7.3,-8142624,Drama
2006,4857376,13000000,7.3,-8142624,Romance
2006,1172769,13000000,7.1,-11827231,Biography
2006,1172769,13000000,7.1,-11827231,Comedy
2006,1172769,13000000,7.1,-11827231,Crime
2006,1172769,13000000,7.1,-11827231,Drama
2006,1150403,13000000,7.1,-11849597,Biography
2006,1150403,13000000,7.1,-11849597,Crime
2006,1150403,13000000,7.1,-11849597,Drama
2006,65269010,12000000,6.5,53269010,Crime
2006,65269010,12000000,6.5,53269010,Drama
2006,65269010,12000000,6.5,53269010,Music
2006,65269010,12000000,6.5,53269010,Romance
2006,167007184,150000000,8,17007184,Action
2006,167007184,150000000,8,17007184,Adventure
2006,167007184,150000000,8,17007184,Thriller
2006,18595716,12000000,5.3,6595716,Comedy
2006,18595716,12000000,5.3,6595716,Family
2006,18595716,12000000,5.3,6595716,Fantasy
2006,18595716,12000000,5.3,6595716,Romance
2006,27829874,12000000,7,15829874,Action
2006,27829874,12000000,7,15829874,Crime
2006,27829874,12000000,7,15829874,Thriller
2006,5542025,12000000,6.3,-6457975,Comedy
2006,6754898,12000000,6.2,-5245102,Comedy
2006,6754898,12000000,6.2,-5245102,Drama
2006,352786,11000000,6.8,-10647214,Biography
2006,352786,11000000,6.8,-10647214,Drama
2006,352786,11000000,6.8,-10647214,Music
2006,399879,15000000,6.4,-14600121,Crime
2006,399879,15000000,6.4,-14600121,Drama
2006,399879,15000000,6.4,-14600121,Mystery
2006,399879,15000000,6.4,-14600121,Thriller
2006,3275443,700000000,6,-696724557,Drama
2006,80150343,10000000,6.2,70150343,Horror
2006,80150343,10000000,6.2,70150343,Mystery
2006,63231524,6000000,5,57231524,Comedy
2006,63231524,6000000,5,57231524,Drama
2006,63231524,6000000,5,57231524,Romance
2006,28435406,12000000,5.5,16435406,Comedy
2006,28435406,12000000,5.5,16435406,Romance
2006,20338609,10000000,6.8,10338609,Comedy
2006,20338609,10000000,6.8,10338609,Drama
2006,20338609,10000000,6.8,10338609,Music
2006,5484375,10000000,7.3,-4515625,Adventure
2006,5484375,10000000,7.3,-4515625,Biography
2006,5484375,10000000,7.3,-4515625,Drama
2006,5484375,10000000,7.3,-4515625,War
2006,1055654,10000000,7.3,-8944346,Drama
2006,1055654,10000000,7.3,-8944346,Romance
2006,1055654,10000000,7.3,-8944346,Sport
2006,136432,5000000,6.6,-4863568,Comedy
2006,136432,5000000,6.6,-4863568,Horror
2006,136432,5000000,6.6,-4863568,Thriller
2006,16235293,9000000,4.5,7235293,Horror
2006,13751,11400000,6.6,-11386249,Drama
2006,13751,11400000,6.6,-11386249,Family
2006,59889948,8000000,7.9,51889948,Comedy
2006,59889948,8000000,7.9,51889948,Drama
2006,298110,8000000,6.8,-7701890,Comedy
2006,298110,8000000,6.8,-7701890,Drama
2006,298110,8000000,6.8,-7701890,Horror
2006,298110,8000000,6.8,-7701890,Sci-Fi
2006,53481,8000000,6.4,-7946519,Crime
2006,53481,8000000,6.4,-7946519,Drama
2006,53481,8000000,6.4,-7946519,Thriller
2006,1654367,7000000,6.4,-5345633,Biography
2006,1654367,7000000,6.4,-5345633,Drama
2006,13367101,6500000,5.9,6867101,Comedy
2006,13367101,6500000,5.9,6867101,Drama
2006,13367101,6500000,5.9,6867101,Romance
2006,17605861,6000000,7.7,11605861,Biography
2006,17605861,6000000,7.7,11605861,Drama
2006,17605861,6000000,7.7,11605861,History
2006,17605861,6000000,7.7,11605861,Thriller
2006,117560,6000000,6.2,-5882440,Drama
2006,117560,6000000,6.2,-5882440,Romance
2006,7009668,5600000,2.1,1409668,Action
2006,7009668,5600000,2.1,1409668,Sport
2006,24138847,5000000,7.4,19138847,Comedy
2006,617228,84450000,7.4,-83832772,Comedy
2006,617228,84450000,7.4,-83832772,Drama
2006,617228,84450000,7.4,-83832772,Romance
2006,617228,84450000,7.4,-83832772,War
2006,49413,35000000,7.3,-34950587,Action
2006,49413,35000000,7.3,-34950587,Crime
2006,49413,35000000,7.3,-34950587,Thriller
2006,10515579,4000000,6.7,6515579,Comedy
2006,10515579,4000000,6.7,6515579,Crime
2006,10515579,4000000,6.7,6515579,Mystery
2006,7825820,4000000,5.9,3825820,Crime
2006,7825820,4000000,5.9,3825820,Mystery
2006,7825820,4000000,5.9,3825820,Thriller
2006,2706659,2000000,6.9,706659,Comedy
2006,2706659,2000000,6.9,706659,Drama
2006,220234,3500000,6.5,-3279766,Comedy
2006,220234,3500000,6.5,-3279766,Romance
2006,8108247,3300000,7.4,4808247,Drama
2006,8108247,3300000,7.4,4808247,Romance
2006,7059537,3000000,3,4059537,Comedy
2006,252726,3000000,7.2,-2747274,Drama
2006,252726,3000000,7.2,-2747274,Family
2006,252726,3000000,7.2,-2747274,Western
2006,475000,2800000,6,-2325000,Comedy
2006,475000,2800000,6,-2325000,Sport
2006,118666,2500000,6.6,-2381334,Drama
2006,71904,2500000,5.7,-2428096,Comedy
2006,71904,2500000,5.7,-2428096,Drama
2006,71904,2500000,5.7,-2428096,Family
2006,978908,2400000,5.1,-1421092,Drama
2006,978908,2400000,5.1,-1421092,Horror
2006,978908,2400000,5.1,-1421092,Mystery
2006,978908,2400000,5.1,-1421092,Thriller
2006,327919,1500000,7.7,-1172081,Crime
2006,327919,1500000,7.7,-1172081,Drama
2006,11284657,2000000,8.5,9284657,Drama
2006,11284657,2000000,8.5,9284657,Thriller
2006,1984378,2000000,6.5,-15622,Comedy
2006,1984378,2000000,6.5,-15622,Drama
2006,1984378,2000000,6.5,-15622,Romance
2006,198407,2000000,6.6,-1801593,Drama
2006,18435,1400000,5.8,-1381565,Drama
2006,155972,1500000,7.3,-1344028,Comedy
2006,155972,1500000,7.3,-1344028,Drama
2006,155972,1500000,7.3,-1344028,Romance
2006,194568,1500000,6.2,-1305432,Comedy
2006,194568,1500000,6.2,-1305432,Romance
2006,638951,1592000,7.4,-953049,Drama
2006,22494487,27000000,7.8,-4505513,Crime
2006,22494487,27000000,7.8,-4505513,Drama
2006,22494487,27000000,7.8,-4505513,Mystery
2006,22494487,27000000,7.8,-4505513,Thriller
2006,1677838,1000000,7.7,677838,Documentary
2006,104077,1000000,7.4,-895923,Comedy
2006,104077,1000000,7.4,-895923,Drama
2006,104077,1000000,7.4,-895923,Fantasy
2006,104077,1000000,7.4,-895923,Romance
2006,144431,1000000,7.3,-855569,Documentary
2006,144431,1000000,7.3,-855569,Sport
2006,10018,1000000,6.1,-989982,Crime
2006,10018,1000000,6.1,-989982,Drama
2006,10018,1000000,6.1,-989982,Thriller
2006,6387,1000000,6.9,-993613,Comedy
2006,6387,1000000,6.9,-993613,Drama
2006,6387,1000000,6.9,-993613,Sci-Fi
2006,721,1000000,4.1,-999279,Action
2006,721,1000000,4.1,-999279,Drama
2006,2694973,700000,7.2,1994973,Drama
2006,23000,500000,6.2,-477000,Comedy
2006,23000,500000,6.2,-477000,Horror
2006,23000,500000,6.2,-477000,Musical
2006,1689999,400000,7.1,1289999,Drama
2006,255352,300000,6.7,-44648,Drama
2006,1111,200000,7.7,-198889,Crime
2006,1111,200000,7.7,-198889,Documentary
2006,10174663,100000,6.7,10074663,Drama
2006,10174663,100000,6.7,10074663,Sport
2005,218051260,207000000,7.2,11051260,Action
2005,218051260,207000000,7.2,11051260,Adventure
2005,218051260,207000000,7.2,11051260,Drama
2005,218051260,207000000,7.2,11051260,Romance
2005,291709845,180000000,6.9,111709845,Adventure
2005,291709845,180000000,6.9,111709845,Family
2005,291709845,180000000,6.9,111709845,Fantasy
2005,289994397,150000000,7.6,139994397,Adventure
2005,289994397,150000000,7.6,139994397,Family
2005,289994397,150000000,7.6,139994397,Fantasy
2005,289994397,150000000,7.6,139994397,Mystery
2005,206456431,150000000,6.7,56456431,Adventure
2005,206456431,150000000,6.7,56456431,Comedy
2005,206456431,150000000,6.7,56456431,Family
2005,206456431,150000000,6.7,56456431,Fantasy
2005,205343774,150000000,8.3,55343774,Action
2005,205343774,150000000,8.3,55343774,Adventure
2005,110332737,100000000,6.1,10332737,Comedy
2005,110332737,100000000,6.1,10332737,Crime
2005,31704416,135000000,5,-103295584,Action
2005,31704416,135000000,5,-103295584,Adventure
2005,31704416,135000000,5,-103295584,Sci-Fi
2005,31704416,135000000,5,-103295584,Thriller
2005,68642452,130000000,6,-61357548,Action
2005,68642452,130000000,6,-61357548,Adventure
2005,68642452,130000000,6,-61357548,Comedy
2005,68642452,130000000,6,-61357548,Thriller
2005,234277056,132000000,6.5,102277056,Adventure
2005,234277056,132000000,6.5,102277056,Sci-Fi
2005,234277056,132000000,6.5,102277056,Thriller
2005,380262555,113000000,7.6,267262555,Action
2005,380262555,113000000,7.6,267262555,Adventure
2005,380262555,113000000,7.6,267262555,Fantasy
2005,380262555,113000000,7.6,267262555,Sci-Fi
2005,186336103,120000000,6.5,66336103,Action
2005,186336103,120000000,6.5,66336103,Comedy
2005,186336103,120000000,6.5,66336103,Crime
2005,186336103,120000000,6.5,66336103,Romance
2005,186336103,120000000,6.5,66336103,Thriller
2005,47396698,130000000,7.2,-82603302,Action
2005,47396698,130000000,7.2,-82603302,Adventure
2005,47396698,130000000,7.2,-82603302,Drama
2005,47396698,130000000,7.2,-82603302,History
2005,47396698,130000000,7.2,-82603302,War
2005,35799026,126000000,6.9,-90200974,Action
2005,35799026,126000000,6.9,-90200974,Adventure
2005,35799026,126000000,6.9,-90200974,Romance
2005,35799026,126000000,6.9,-90200974,Sci-Fi
2005,35799026,126000000,6.9,-90200974,Thriller
2005,17010646,84000000,2.2,-66989354,Comedy
2005,17010646,84000000,2.2,-66989354,Family
2005,17010646,84000000,2.2,-66989354,Fantasy
2005,72515360,80000000,6.4,-7484640,Crime
2005,72515360,80000000,6.4,-7484640,Mystery
2005,72515360,80000000,6.4,-7484640,Thriller
2005,61644321,88000000,8,-26355679,Biography
2005,61644321,88000000,8,-26355679,Drama
2005,61644321,88000000,8,-26355679,Sport
2005,57010853,85000000,7.3,-27989147,Drama
2005,57010853,85000000,7.3,-27989147,Romance
2005,158115031,82000000,6.4,76115031,Comedy
2005,158115031,82000000,6.4,76115031,Crime
2005,158115031,82000000,6.4,76115031,Sport
2005,128200012,75000000,6.3,53200012,Adventure
2005,128200012,75000000,6.3,53200012,Animation
2005,128200012,75000000,6.3,53200012,Comedy
2005,128200012,75000000,6.3,53200012,Family
2005,128200012,75000000,6.3,53200012,Sci-Fi
2005,45356386,75000000,5.9,-29643614,Action
2005,45356386,75000000,5.9,-29643614,Adventure
2005,45356386,75000000,5.9,-29643614,Western
2005,37899638,88000000,5.9,-50100362,Action
2005,37899638,88000000,5.9,-50100362,Adventure
2005,37899638,88000000,5.9,-50100362,Comedy
2005,37899638,88000000,5.9,-50100362,Fantasy
2005,37899638,88000000,5.9,-50100362,Thriller
2005,1891821,52000000,4.2,-50108179,Action
2005,1891821,52000000,4.2,-50108179,Adventure
2005,1891821,52000000,4.2,-50108179,Horror
2005,1891821,52000000,4.2,-50108179,Sci-Fi
2005,1891821,52000000,4.2,-50108179,Thriller
2005,193136719,75000000,6.9,118136719,Adventure
2005,193136719,75000000,6.9,118136719,Animation
2005,193136719,75000000,6.9,118136719,Comedy
2005,193136719,75000000,6.9,118136719,Family
2005,55808744,53000000,5.7,2808744,Comedy
2005,55808744,53000000,5.7,2808744,Crime
2005,55808744,53000000,5.7,2808744,Music
2005,47379090,70000000,7.6,-22620910,Drama
2005,47379090,70000000,7.6,-22620910,History
2005,47379090,70000000,7.6,-22620910,Thriller
2005,34636443,52000000,6.6,-17363557,Action
2005,34636443,52000000,6.6,-17363557,Crime
2005,34636443,52000000,6.6,-17363557,Drama
2005,34636443,52000000,6.6,-17363557,Mystery
2005,34636443,52000000,6.6,-17363557,Thriller
2005,62647540,70000000,7.1,-7352460,Action
2005,62647540,70000000,7.1,-7352460,Drama
2005,62647540,70000000,7.1,-7352460,War
2005,28031250,60000000,5.2,-31968750,Action
2005,28031250,60000000,5.2,-31968750,Adventure
2005,28031250,60000000,5.2,-31968750,Horror
2005,28031250,60000000,5.2,-31968750,Sci-Fi
2005,28045540,65000000,6.1,-36954460,Action
2005,28045540,65000000,6.1,-36954460,Adventure
2005,28045540,65000000,6.1,-36954460,Comedy
2005,28045540,65000000,6.1,-36954460,Family
2005,28045540,65000000,6.1,-36954460,Fantasy
2005,28045540,65000000,6.1,-36954460,Sci-Fi
2005,1987287,50000000,6.9,-48012713,Crime
2005,1987287,50000000,6.9,-48012713,Drama
2005,24407944,43000000,4.8,-18592056,Action
2005,24407944,43000000,4.8,-18592056,Crime
2005,24407944,43000000,4.8,-18592056,Fantasy
2005,24407944,43000000,4.8,-18592056,Thriller
2005,135381507,150000000,5.8,-14618493,Adventure
2005,135381507,150000000,5.8,-14618493,Animation
2005,135381507,150000000,5.8,-14618493,Comedy
2005,135381507,150000000,5.8,-14618493,Family
2005,135381507,150000000,5.8,-14618493,Sci-Fi
2005,82569532,60000000,5.4,22569532,Adventure
2005,82569532,60000000,5.4,22569532,Comedy
2005,82569532,60000000,5.4,22569532,Family
2005,48472213,45000000,5,3472213,Action
2005,48472213,45000000,5,3472213,Comedy
2005,48472213,45000000,5,3472213,Crime
2005,26082914,87000000,4.3,-60917086,Action
2005,26082914,87000000,4.3,-60917086,Adventure
2005,26082914,87000000,4.3,-60917086,Crime
2005,26082914,87000000,4.3,-60917086,Thriller
2005,25472967,30000000,5.6,-4527033,Drama
2005,25472967,30000000,5.6,-4527033,Horror
2005,25472967,30000000,5.6,-4527033,Thriller
2005,10166502,80000000,6.7,-69833498,Action
2005,10166502,80000000,6.7,-69833498,Drama
2005,10166502,80000000,6.7,-69833498,War
2005,48291624,58000000,6.7,-9708376,Comedy
2005,48291624,58000000,6.7,-9708376,Fantasy
2005,48291624,58000000,6.7,-9708376,Romance
2005,113006880,56000000,5.5,57006880,Action
2005,113006880,56000000,5.5,57006880,Comedy
2005,113006880,56000000,5.5,57006880,Drama
2005,113006880,56000000,5.5,57006880,Family
2005,113006880,56000000,5.5,57006880,Thriller
2005,177575142,70000000,6.6,107575142,Comedy
2005,177575142,70000000,6.6,107575142,Romance
2005,89706988,55000000,6.2,34706988,Drama
2005,89706988,55000000,6.2,34706988,Mystery
2005,89706988,55000000,6.2,34706988,Thriller
2005,25857987,62000000,5.5,-36142013,Action
2005,25857987,62000000,5.5,-36142013,Sci-Fi
2005,26838389,57000000,6.4,-30161611,Comedy
2005,26838389,57000000,6.4,-30161611,Drama
2005,26838389,57000000,6.4,-30161611,Romance
2005,80270227,50000000,5.1,30270227,Action
2005,80270227,50000000,5.1,30270227,Adventure
2005,80270227,50000000,5.1,30270227,Comedy
2005,70496802,54000000,8.2,16496802,Action
2005,70496802,54000000,8.2,16496802,Drama
2005,70496802,54000000,8.2,16496802,Thriller
2005,66002004,50000000,4.7,16002004,Adventure
2005,66002004,50000000,4.7,16002004,Comedy
2005,66002004,50000000,4.7,16002004,Family
2005,66002004,50000000,4.7,16002004,Fantasy
2005,66002004,50000000,4.7,16002004,Romance
2005,66002004,50000000,4.7,16002004,Sport
2005,50815288,50000000,7,815288,Drama
2005,50815288,50000000,7,815288,Thriller
2005,39177541,50000000,3.5,-10822459,Action
2005,39177541,50000000,3.5,-10822459,Adventure
2005,39177541,50000000,3.5,-10822459,Family
2005,39177541,50000000,3.5,-10822459,Fantasy
2005,19118247,40000000,5.4,-20881753,Action
2005,19118247,40000000,5.4,-20881753,Comedy
2005,18472363,50000000,5.8,-31527637,Action
2005,18472363,50000000,5.8,-31527637,Adventure
2005,18472363,50000000,5.8,-31527637,Crime
2005,18472363,50000000,5.8,-31527637,Thriller
2005,10137232,50000000,6,-39862768,Action
2005,10137232,50000000,6,-39862768,Biography
2005,10137232,50000000,6,-39862768,Crime
2005,10137232,50000000,6,-39862768,Drama
2005,10137232,50000000,6,-39862768,Thriller
2005,82931301,60000000,5.5,22931301,Comedy
2005,82931301,60000000,5.5,22931301,Romance
2005,67253092,30000000,7.2,37253092,Drama
2005,67253092,30000000,7.2,37253092,Sport
2005,52580895,45000000,5.6,7580895,Comedy
2005,52580895,45000000,5.6,7580895,Family
2005,52580895,45000000,5.6,7580895,Romance
2005,52580895,45000000,5.6,7580895,Sport
2005,51019112,50000000,6.8,1019112,Adventure
2005,51019112,50000000,6.8,1019112,Comedy
2005,51019112,50000000,6.8,1019112,Sci-Fi
2005,19377727,45000000,6.4,-25622273,Comedy
2005,19377727,45000000,6.4,-25622273,Musical
2005,24520892,45000000,7,-20479108,Action
2005,24520892,45000000,7,-20479108,Crime
2005,24520892,45000000,7,-20479108,Drama
2005,24520892,45000000,7,-20479108,Thriller
2005,24127895,50000000,7.6,-25872105,Crime
2005,24127895,50000000,7.6,-25872105,Drama
2005,24127895,50000000,7.6,-25872105,Thriller
2005,74098862,40000000,8.1,34098862,Crime
2005,74098862,40000000,8.1,34098862,Thriller
2005,47806295,43000000,6.5,4806295,Horror
2005,47806295,43000000,6.5,4806295,Mystery
2005,47806295,43000000,6.5,4806295,Thriller
2005,42071069,30000000,6.2,12071069,Comedy
2005,42071069,30000000,6.2,12071069,Drama
2005,42071069,30000000,6.2,12071069,Romance
2005,42071069,30000000,6.2,12071069,Sport
2005,30981850,40000000,5,-9018150,Biography
2005,30981850,40000000,5,-9018150,Crime
2005,30981850,40000000,5,-9018150,Drama
2005,30981850,40000000,5,-9018150,Music
2005,29077547,40000000,7,-10922453,Drama
2005,29077547,40000000,7,-10922453,Musical
2005,29077547,40000000,7,-10922453,Romance
2005,77231,25000000,6,-24922769,Drama
2005,77231,25000000,6,-24922769,History
2005,77231,25000000,6,-24922769,War
2005,25335935,40000000,8,-14664065,Action
2005,25335935,40000000,8,-14664065,Adventure
2005,25335935,40000000,8,-14664065,Sci-Fi
2005,25335935,40000000,8,-14664065,Thriller
2005,67962333,35000000,5.9,32962333,Comedy
2005,67962333,35000000,5.9,32962333,Romance
2005,63939454,35000000,6.2,28939454,Adventure
2005,63939454,35000000,6.2,28939454,Comedy
2005,63939454,35000000,6.2,28939454,Family
2005,63939454,35000000,6.2,28939454,Sci-Fi
2005,43894863,30000000,5.9,13894863,Comedy
2005,43894863,30000000,5.9,13894863,Romance
2005,32048809,30000000,5.3,2048809,Horror
2005,19447478,35000000,5.6,-15552522,Adventure
2005,19447478,35000000,5.6,-15552522,Animation
2005,19447478,35000000,5.6,-15552522,Comedy
2005,19447478,35000000,5.6,-15552522,Family
2005,19447478,35000000,5.6,-15552522,War
2005,19294901,35000000,5,-15705099,Comedy
2005,19294901,35000000,5,-15705099,Horror
2005,4280577,10000000,6.8,-5719423,Drama
2005,4280577,10000000,6.8,-5719423,Romance
2005,4280577,10000000,6.8,-5719423,Sport
2005,32701088,32000000,6.9,701088,Drama
2005,32701088,32000000,6.9,701088,Family
2005,32701088,32000000,6.9,701088,Sport
2005,31493782,32000000,7.5,-506218,Crime
2005,31493782,32000000,7.5,-506218,Drama
2005,31493782,32000000,7.5,-506218,Thriller
2005,43095600,32000000,6.3,11095600,Action
2005,43095600,32000000,6.3,11095600,Crime
2005,43095600,32000000,6.3,11095600,Thriller
2005,74484168,45000000,6.9,29484168,Action
2005,74484168,45000000,6.9,29484168,Crime
2005,74484168,45000000,6.9,29484168,Drama
2005,74484168,45000000,6.9,29484168,Mystery
2005,74484168,45000000,6.9,29484168,Thriller
2005,56068547,30000000,7.5,26068547,Animation
2005,56068547,30000000,7.5,26068547,Comedy
2005,56068547,30000000,7.5,26068547,Family
2005,56068547,30000000,7.5,26068547,Mystery
2005,56068547,30000000,7.5,26068547,Sci-Fi
2005,53337608,40000000,7.4,13337608,Animation
2005,53337608,40000000,7.4,13337608,Drama
2005,53337608,40000000,7.4,13337608,Family
2005,53337608,40000000,7.4,13337608,Fantasy
2005,53337608,40000000,7.4,13337608,Musical
2005,53337608,40000000,7.4,13337608,Romance
2005,19976073,20000000,6.3,-23927,Action
2005,19976073,20000000,6.3,-23927,Crime
2005,19976073,20000000,6.3,-23927,Drama
2005,19976073,20000000,6.3,-23927,Thriller
2005,18324242,35000000,7.3,-16675758,Drama
2005,14888028,30000000,5.1,-15111972,Adventure
2005,14888028,30000000,5.1,-15111972,Horror
2005,14888028,30000000,5.1,-15111972,Thriller
2005,12712093,30000000,6.7,-17287907,Biography
2005,12712093,30000000,6.7,-17287907,Drama
2005,12712093,30000000,6.7,-17287907,History
2005,12712093,30000000,6.7,-17287907,Romance
2005,8535575,30000000,7,-21464425,Drama
2005,668171,60000000,5.6,-59331829,Action
2005,668171,60000000,5.6,-59331829,Drama
2005,668171,60000000,5.6,-59331829,Fantasy
2005,119518352,28000000,7.9,91518352,Biography
2005,119518352,28000000,7.9,91518352,Drama
2005,119518352,28000000,7.9,91518352,Music
2005,119518352,28000000,7.9,91518352,Romance
2005,6301131,29000000,7.1,-22698869,Drama
2005,6301131,29000000,7.1,-22698869,Mystery
2005,6301131,29000000,7.1,-22698869,Sci-Fi
2005,6301131,29000000,7.1,-22698869,Thriller
2005,38372662,28000000,7.8,10372662,Drama
2005,38372662,28000000,7.8,10372662,Romance
2005,109243478,26000000,7.1,83243478,Comedy
2005,109243478,26000000,7.1,83243478,Romance
2005,57859105,26000000,6.5,31859105,Mystery
2005,57859105,26000000,6.5,31859105,Thriller
2005,33565375,15000000,7.5,18565375,Drama
2005,33565375,15000000,7.5,18565375,Mystery
2005,33565375,15000000,7.5,18565375,Romance
2005,33565375,15000000,7.5,18565375,Thriller
2005,51097664,30000000,5.9,21097664,Drama
2005,51097664,30000000,5.9,21097664,Horror
2005,51097664,30000000,5.9,21097664,Mystery
2005,51097664,30000000,5.9,21097664,Thriller
2005,47124400,25000000,6.6,22124400,Comedy
2005,47124400,25000000,6.6,22124400,Family
2005,47124400,25000000,6.6,22124400,Fantasy
2005,39008741,25000000,6.6,14008741,Comedy
2005,39008741,25000000,6.6,14008741,Drama
2005,39008741,25000000,6.6,14008741,Family
2005,39008741,25000000,6.6,14008741,Romance
2005,21835784,30000000,6.6,-8164216,Comedy
2005,21835784,30000000,6.6,-8164216,Drama
2005,21835784,30000000,6.6,-8164216,Romance
2005,11008432,25000000,7.1,-13991568,Biography
2005,11008432,25000000,7.1,-13991568,Drama
2005,11008432,25000000,7.1,-13991568,Sport
2005,5654777,25000000,4.1,-19345223,Action
2005,5654777,25000000,4.1,-19345223,Comedy
2005,5654777,25000000,4.1,-19345223,Crime
2005,5654777,25000000,4.1,-19345223,Drama
2005,5654777,25000000,4.1,-19345223,Thriller
2005,5128124,25000000,7.9,-19871876,Biography
2005,5128124,25000000,7.9,-19871876,Drama
2005,5128124,25000000,7.9,-19871876,Sport
2005,4006906,15000000,4.1,-10993094,Comedy
2005,4006906,15000000,4.1,-10993094,Crime
2005,1550000,25000000,2.9,-23450000,Action
2005,1550000,25000000,2.9,-23450000,Adventure
2005,1550000,25000000,2.9,-23450000,Fantasy
2005,1550000,25000000,2.9,-23450000,Horror
2005,871527,25000000,6.5,-24128473,Crime
2005,871527,25000000,6.5,-24128473,Drama
2005,871527,25000000,6.5,-24128473,Mystery
2005,871527,25000000,6.5,-24128473,Thriller
2005,218051260,207000000,7.2,11051260,Action
2005,218051260,207000000,7.2,11051260,Adventure
2005,218051260,207000000,7.2,11051260,Drama
2005,218051260,207000000,7.2,11051260,Romance
2005,36020063,22000000,6.6,14020063,Drama
2005,36020063,22000000,6.6,14020063,Thriller
2005,22264487,22000000,4.6,264487,Comedy
2005,35799026,126000000,6.9,-90200974,Action
2005,35799026,126000000,6.9,-90200974,Adventure
2005,35799026,126000000,6.9,-90200974,Romance
2005,35799026,126000000,6.9,-90200974,Sci-Fi
2005,35799026,126000000,6.9,-90200974,Thriller
2005,1050445,22000000,7.8,-20949555,Drama
2005,1050445,22000000,7.8,-20949555,History
2005,1050445,22000000,7.8,-20949555,Music
2005,1050445,22000000,7.8,-20949555,Romance
2005,1050445,22000000,7.8,-20949555,War
2005,82301521,32000000,4.6,50301521,Adventure
2005,82301521,32000000,4.6,50301521,Comedy
2005,82301521,32000000,4.6,50301521,Family
2005,82301521,32000000,4.6,50301521,Romance
2005,46363118,20000000,4.1,26363118,Drama
2005,46363118,20000000,4.1,26363118,Horror
2005,46363118,20000000,4.1,26363118,Mystery
2005,46363118,20000000,4.1,26363118,Thriller
2005,18081626,20000000,6.4,-1918374,Animation
2005,18081626,20000000,6.4,-1918374,Family
2005,18081626,20000000,6.4,-1918374,Fantasy
2005,18081626,20000000,6.4,-1918374,Mystery
2005,12469811,22000000,6.6,-9530189,Comedy
2005,12469811,22000000,6.6,-9530189,Drama
2005,11034436,20000000,7.1,-8965564,Comedy
2005,11034436,20000000,7.1,-8965564,Drama
2005,11034436,20000000,7.1,-8965564,Music
2005,11034436,20000000,7.1,-8965564,War
2005,8326035,33000000,5.5,-24673965,Action
2005,8326035,33000000,5.5,-24673965,Comedy
2005,8326035,33000000,5.5,-24673965,Crime
2005,5132655,20000000,2.3,-14867345,Horror
2005,5132655,20000000,2.3,-14867345,Sci-Fi
2005,1900725,2000000,7.4,-99275,Crime
2005,1900725,2000000,7.4,-99275,Drama
2005,1900725,2000000,7.4,-99275,Western
2005,375474,20000000,6.2,-19624526,Drama
2005,375474,20000000,6.2,-19624526,History
2005,375474,20000000,6.2,-19624526,Sport
2005,64255243,19000000,6,45255243,Drama
2005,64255243,19000000,6,45255243,Horror
2005,64255243,19000000,6,45255243,Mystery
2005,64255243,19000000,6,45255243,Thriller
2005,20433940,15000000,6.2,5433940,Horror
2005,75072454,20000000,6.7,55072454,Drama
2005,75072454,20000000,6.7,55072454,Horror
2005,75072454,20000000,6.7,55072454,Thriller
2005,6061759,17000000,6.3,-10938241,Comedy
2005,6061759,17000000,6.3,-10938241,Drama
2005,6061759,17000000,6.3,-10938241,Romance
2005,51053787,17500000,6.5,33553787,Action
2005,51053787,17500000,6.5,33553787,Animation
2005,51053787,17500000,6.5,33553787,Comedy
2005,51053787,17500000,6.5,33553787,Crime
2005,51053787,17500000,6.5,33553787,Family
2005,1666262,16000000,6.7,-14333738,Drama
2005,1666262,16000000,6.7,-14333738,History
2005,1666262,16000000,6.7,-14333738,Romance
2005,1666262,16000000,6.7,-14333738,War
2005,1181197,15500000,5.9,-14318803,Drama
2005,1181197,15500000,5.9,-14318803,Mystery
2005,1181197,15500000,5.9,-14318803,Thriller
2005,31585300,15000000,6.1,16585300,Comedy
2005,31585300,15000000,6.1,16585300,Romance
2005,32645546,14000000,6.4,18645546,Comedy
2005,32645546,14000000,6.4,18645546,Drama
2005,32645546,14000000,6.4,18645546,Family
2005,23089926,15000000,7.7,8089926,Drama
2005,23089926,15000000,7.7,8089926,Romance
2005,23089926,15000000,7.7,8089926,Thriller
2005,5023275,15000000,7.5,-9976725,Adventure
2005,5023275,15000000,7.5,-9976725,Crime
2005,5023275,15000000,7.5,-9976725,Drama
2005,5023275,15000000,7.5,-9976725,Mystery
2005,5023275,15000000,7.5,-9976725,Western
2005,4235837,15000000,7.6,-10764163,Comedy
2005,4235837,15000000,7.6,-10764163,Crime
2005,4235837,15000000,7.6,-10764163,Mystery
2005,74205,14200000,7.4,-14125795,Drama
2005,16298046,14000000,5,2298046,Horror
2005,16298046,14000000,5,2298046,Mystery
2005,16298046,14000000,5,2298046,Thriller
2005,83025853,14000000,7.7,69025853,Drama
2005,83025853,14000000,7.7,69025853,Romance
2005,18761993,9000000,6.9,9761993,Comedy
2005,18761993,9000000,6.9,9761993,Drama
2005,860002,12000000,7.3,-11139998,Adventure
2005,860002,12000000,7.3,-11139998,Drama
2005,860002,12000000,7.3,-11139998,Family
2005,55865715,10000000,5.5,45865715,Drama
2005,55865715,10000000,5.5,45865715,Horror
2005,55865715,10000000,5.5,45865715,Mystery
2005,55865715,10000000,5.5,45865715,Thriller
2005,16247775,25000000,5.5,-8752225,Comedy
2005,16247775,25000000,5.5,-8752225,Family
2005,16247775,25000000,5.5,-8752225,Romance
2005,12570442,10000000,6.8,2570442,Comedy
2005,12570442,10000000,6.8,2570442,Crime
2005,12570442,10000000,6.8,2570442,Drama
2005,12570442,10000000,6.8,2570442,Thriller
2005,11703287,10000000,7,1703287,Adventure
2005,11703287,10000000,7,1703287,Drama
2005,131617,10000000,6.3,-9868383,Drama
2005,131617,10000000,6.3,-9868383,Thriller
2005,2483955,9600000,6.7,-7116045,Drama
2005,2483955,9600000,6.7,-7116045,Romance
2005,1530535,9000000,5.7,-7469465,Comedy
2005,1530535,9000000,5.7,-7469465,Drama
2005,1530535,9000000,5.7,-7469465,Romance
2005,1046166,9000000,4.2,-7953834,Comedy
2005,1046166,9000000,4.2,-7953834,Music
2005,1046166,9000000,4.2,-7953834,Romance
2005,50815288,50000000,7,815288,Drama
2005,50815288,50000000,7,815288,Thriller
2005,568695,8000000,6.5,-7431305,Drama
2005,568695,8000000,6.5,-7431305,Romance
2005,568695,8000000,6.5,-7431305,Thriller
2005,127144,8000000,5.5,-7872856,Comedy
2005,127144,8000000,5.5,-7872856,Drama
2005,127144,8000000,5.5,-7872856,Romance
2005,671240,7900000,6.9,-7228760,Comedy
2005,671240,7900000,6.9,-7228760,Drama
2005,671240,7900000,6.9,-7228760,Romance
2005,24792061,6500000,7.6,18292061,Comedy
2005,24792061,6500000,7.6,18292061,Drama
2005,31501218,7500000,7.5,24001218,Biography
2005,31501218,7500000,7.5,24001218,Drama
2005,31501218,7500000,7.5,24001218,History
2005,28747570,7000000,7.4,21747570,Biography
2005,28747570,7000000,7.4,21747570,Crime
2005,28747570,7000000,7.4,21747570,Drama
2005,26005908,3500000,7.2,22505908,Adventure
2005,26005908,3500000,7.2,22505908,Horror
2005,26005908,3500000,7.2,22505908,Thriller
2005,16901126,7000000,6.9,9901126,Crime
2005,16901126,7000000,6.9,9901126,Horror
2005,233103,7000000,6.9,-6766897,Drama
2005,49526,6800000,7,-6750474,Comedy
2005,49526,6800000,7,-6750474,Drama
2005,2024854,6500000,6.6,-4475146,Drama
2005,2024854,6500000,6.6,-4475146,Western
2005,11905519,200000000,7.1,-188094481,Action
2005,11905519,200000000,7.1,-188094481,Crime
2005,11905519,200000000,7.1,-188094481,Drama
2005,11905519,200000000,7.1,-188094481,Thriller
2005,50382128,5500000,5.6,44882128,Comedy
2005,50382128,5500000,5.6,44882128,Drama
2005,50382128,5500000,5.6,44882128,Romance
2005,87025093,4000000,6.6,83025093,Horror
2005,87025093,4000000,6.6,83025093,Mystery
2005,47277326,4800000,5.9,42477326,Horror
2005,1247453,2800000,6.8,-1552547,Comedy
2005,1247453,2800000,6.8,-1552547,Drama
2005,1325073,4000000,6.6,-2674927,Comedy
2005,1325073,4000000,6.6,-2674927,Drama
2005,864959,4000000,6.9,-3135041,Adventure
2005,864959,4000000,6.9,-3135041,Fantasy
2005,101228,3500000,6.4,-3398772,Comedy
2005,101228,3500000,6.4,-3398772,Drama
2005,77413017,8000000,7.6,69413017,Documentary
2005,11694528,3000000,7.2,8694528,Comedy
2005,11694528,3000000,7.2,8694528,Documentary
2005,11694528,3000000,7.2,8694528,Music
2005,2912363,3000000,7.3,-87637,Crime
2005,2912363,3000000,7.3,-87637,Drama
2005,3123749,1500000,6.5,1623749,Comedy
2005,3123749,1500000,6.5,1623749,Romance
2005,22201636,8000000,7.4,14201636,Crime
2005,22201636,8000000,7.4,14201636,Drama
2005,22201636,8000000,7.4,14201636,Music
2005,3885134,2000000,7.4,1885134,Comedy
2005,3885134,2000000,7.4,1885134,Drama
2005,3335839,2000000,7,1335839,Action
2005,3335839,2000000,7,1335839,Crime
2005,3335839,2000000,7,1335839,Drama
2005,3335839,2000000,7,1335839,Thriller
2005,653621,2000000,6.8,-1346379,Biography
2005,653621,2000000,6.8,-1346379,Documentary
2005,653621,2000000,6.8,-1346379,History
2005,12667,14000,6.6,-1333,Drama
2005,12667,14000,6.6,-1333,Romance
2005,129319,70000000,5.1,-69870681,Romance
2005,7362100,1500000,7.4,5862100,Comedy
2005,7362100,1500000,7.4,5862100,Drama
2005,712294,1500000,6.7,-787706,Drama
2005,92362,1500000,4.3,-1407638,Comedy
2005,92362,1500000,4.3,-1407638,Drama
2005,100358,1500000,3.3,-1399642,Comedy
2005,100358,1500000,3.3,-1399642,Musical
2005,100358,1500000,3.3,-1399642,Romance
2005,16101109,3000000,6.8,13101109,Comedy
2005,10042266,1000000,5.9,9042266,Drama
2005,10042266,1000000,5.9,9042266,Horror
2005,10042266,1000000,5.9,9042266,Mystery
2005,10042266,1000000,5.9,9042266,Thriller
2005,9013113,1000000,7.4,8013113,Adventure
2005,9013113,1000000,7.4,8013113,Comedy
2005,9013113,1000000,7.4,8013113,Drama
2005,49000,1500000,4.8,-1451000,Thriller
2005,1007962,950000,7.1,57962,Crime
2005,1007962,950000,7.1,57962,Drama
2005,1007962,950000,7.1,57962,Thriller
2005,381186,900000,6.4,-518814,Drama
2005,381186,900000,6.4,-518814,Thriller
2005,218051260,207000000,7.2,11051260,Action
2005,218051260,207000000,7.2,11051260,Adventure
2005,218051260,207000000,7.2,11051260,Drama
2005,218051260,207000000,7.2,11051260,Romance
2005,32048809,30000000,5.3,2048809,Horror
2005,154077,500000,6.6,-345923,Comedy
2005,154077,500000,6.6,-345923,Drama
2005,379122,450000,7.1,-70878,Comedy
2005,379122,450000,7.1,-70878,Drama
2005,379122,450000,7.1,-70878,Romance
2005,1523883,1750211,7.8,-226328,Documentary
2005,1523883,1750211,7.8,-226328,Sport
2005,192467,15000,6.6,177467,Comedy
2005,192467,15000,6.6,177467,Drama
2005,192467,15000,6.6,177467,Romance
2005,70071,7000,6.3,63071,Thriller
2004,373377893,200000000,7.3,173377893,Action
2004,373377893,200000000,7.3,173377893,Adventure
2004,373377893,200000000,7.3,173377893,Fantasy
2004,373377893,200000000,7.3,173377893,Romance
2004,665426,165000000,6.6,-164334574,Adventure
2004,665426,165000000,6.6,-164334574,Animation
2004,665426,165000000,6.6,-164334574,Family
2004,665426,165000000,6.6,-164334574,Fantasy
2004,34293771,155000000,5.5,-120706229,Action
2004,34293771,155000000,5.5,-120706229,Adventure
2004,34293771,155000000,5.5,-120706229,Biography
2004,34293771,155000000,5.5,-120706229,Drama
2004,34293771,155000000,5.5,-120706229,History
2004,34293771,155000000,5.5,-120706229,Romance
2004,34293771,155000000,5.5,-120706229,War
2004,133228348,175000000,7.2,-41771652,Adventure
2004,249358727,130000000,7.8,119358727,Adventure
2004,249358727,130000000,7.8,119358727,Family
2004,249358727,130000000,7.8,119358727,Fantasy
2004,249358727,130000000,7.8,119358727,Mystery
2004,186739919,125000000,6.4,61739919,Action
2004,186739919,125000000,6.4,61739919,Adventure
2004,186739919,125000000,6.4,61739919,Sci-Fi
2004,186739919,125000000,6.4,61739919,Thriller
2004,57637485,105000000,6.7,-47362515,Action
2004,57637485,105000000,6.7,-47362515,Adventure
2004,57637485,105000000,6.7,-47362515,Sci-Fi
2004,57637485,105000000,6.7,-47362515,Thriller
2004,125531634,110000000,6.4,15531634,Crime
2004,125531634,110000000,6.4,15531634,Thriller
2004,102608827,110000000,7.5,-7391173,Biography
2004,102608827,110000000,7.5,-7391173,Drama
2004,50026353,110000000,5.4,-59973647,Animation
2004,50026353,110000000,5.4,-59973647,Comedy
2004,50026353,110000000,5.4,-59973647,Family
2004,50026353,110000000,5.4,-59973647,Music
2004,50026353,110000000,5.4,-59973647,Western
2004,24004159,110000000,5.8,-85995841,Action
2004,24004159,110000000,5.8,-85995841,Adventure
2004,24004159,110000000,5.8,-85995841,Comedy
2004,144795350,120000000,7.1,24795350,Action
2004,144795350,120000000,7.1,24795350,Mystery
2004,144795350,120000000,7.1,24795350,Sci-Fi
2004,144795350,120000000,7.1,24795350,Thriller
2004,173005002,100000000,6.9,73005002,Action
2004,173005002,100000000,6.9,73005002,Adventure
2004,173005002,100000000,6.9,73005002,Comedy
2004,173005002,100000000,6.9,73005002,Family
2004,173005002,100000000,6.9,73005002,Mystery
2004,40198710,100000000,3.3,-59801290,Action
2004,40198710,100000000,3.3,-59801290,Crime
2004,40198710,100000000,3.3,-59801290,Fantasy
2004,40198710,100000000,3.3,-59801290,Romance
2004,40198710,100000000,3.3,-59801290,Thriller
2004,59475623,90000000,5.2,-30524377,Comedy
2004,59475623,90000000,5.2,-30524377,Sci-Fi
2004,59475623,90000000,5.2,-30524377,Thriller
2004,22406362,107000000,6,-84593638,Drama
2004,22406362,107000000,6,-84593638,History
2004,22406362,107000000,6,-84593638,War
2004,22406362,107000000,6,-84593638,Western
2004,261437578,92000000,8,169437578,Action
2004,261437578,92000000,8,169437578,Adventure
2004,261437578,92000000,8,169437578,Animation
2004,261437578,92000000,8,169437578,Family
2004,176049130,75000000,7.8,101049130,Action
2004,176049130,75000000,7.8,101049130,Mystery
2004,176049130,75000000,7.8,101049130,Thriller
2004,65948711,80000000,6.6,-14051289,Drama
2004,65948711,80000000,6.6,-14051289,Mystery
2004,65948711,80000000,6.6,-14051289,Sci-Fi
2004,65948711,80000000,6.6,-14051289,Thriller
2004,67286731,100000000,6.7,-32713269,Action
2004,67286731,100000000,6.7,-32713269,Adventure
2004,67286731,100000000,6.7,-32713269,Western
2004,120776832,75000000,6.8,45776832,Comedy
2004,120776832,75000000,6.8,45776832,Romance
2004,41814863,50000000,5.1,-8185137,Horror
2004,41814863,50000000,5.1,-8185137,Mystery
2004,41814863,50000000,5.1,-8185137,Thriller
2004,77032279,60000000,7.3,17032279,Comedy
2004,77032279,60000000,7.3,17032279,Drama
2004,160762022,75000000,6,85762022,Adventure
2004,160762022,75000000,6,85762022,Animation
2004,160762022,75000000,6,85762022,Comedy
2004,160762022,75000000,6,85762022,Family
2004,42044321,80000000,6.5,-37955679,Comedy
2004,42044321,80000000,6.5,-37955679,Drama
2004,42044321,80000000,6.5,-37955679,Romance
2004,21009180,45000000,6.1,-23990820,Action
2004,21009180,45000000,6.1,-23990820,Adventure
2004,21009180,45000000,6.1,-23990820,Drama
2004,21009180,45000000,6.1,-23990820,Thriller
2004,18947630,59660000,7.1,-40712370,Adventure
2004,18947630,59660000,7.1,-40712370,Drama
2004,18947630,59660000,7.1,-40712370,Family
2004,114195633,60000000,6.5,54195633,Drama
2004,114195633,60000000,6.5,54195633,Mystery
2004,114195633,60000000,6.5,54195633,Romance
2004,114195633,60000000,6.5,54195633,Thriller
2004,436471036,150000000,7.2,286471036,Adventure
2004,436471036,150000000,7.2,286471036,Animation
2004,436471036,150000000,7.2,286471036,Comedy
2004,436471036,150000000,7.2,286471036,Family
2004,436471036,150000000,7.2,286471036,Fantasy
2004,436471036,150000000,7.2,286471036,Romance
2004,80281096,60000000,5.6,20281096,Action
2004,80281096,60000000,5.6,20281096,Horror
2004,80281096,60000000,5.6,20281096,Sci-Fi
2004,80281096,60000000,5.6,20281096,Thriller
2004,37760080,70000000,6.1,-32239920,Action
2004,37760080,70000000,6.1,-32239920,Adventure
2004,37760080,70000000,6.1,-32239920,Mystery
2004,37760080,70000000,6.1,-32239920,Sci-Fi
2004,37760080,70000000,6.1,-32239920,Thriller
2004,52397389,65000000,5.9,-12602611,Action
2004,52397389,65000000,5.9,-12602611,Adventure
2004,52397389,65000000,5.9,-12602611,Fantasy
2004,52397389,65000000,5.9,-12602611,Horror
2004,52397389,65000000,5.9,-12602611,Sci-Fi
2004,52397389,65000000,5.9,-12602611,Thriller
2004,279167575,80000000,6.3,199167575,Comedy
2004,279167575,80000000,6.3,199167575,Romance
2004,100003492,65000000,7.6,35003492,Crime
2004,100003492,65000000,7.6,35003492,Drama
2004,100003492,65000000,7.6,35003492,Thriller
2004,74540762,55000000,6.5,19540762,Action
2004,74540762,55000000,6.5,19540762,Drama
2004,74540762,55000000,6.5,19540762,Thriller
2004,77862546,70000000,7.7,7862546,Action
2004,77862546,70000000,7.7,7862546,Crime
2004,77862546,70000000,7.7,7862546,Drama
2004,77862546,70000000,7.7,7862546,Thriller
2004,88200225,60000000,6.1,28200225,Comedy
2004,88200225,60000000,6.1,28200225,Crime
2004,59035104,66000000,6.8,-6964896,Action
2004,59035104,66000000,6.8,-6964896,Fantasy
2004,59035104,66000000,6.8,-6964896,Horror
2004,59035104,66000000,6.8,-6964896,Sci-Fi
2004,28328132,58000000,6.3,-29671868,Action
2004,28328132,58000000,6.3,-29671868,Comedy
2004,28328132,58000000,6.3,-29671868,Crime
2004,28328132,58000000,6.3,-29671868,Drama
2004,45860039,56000000,6.2,-10139961,Action
2004,45860039,56000000,6.2,-10139961,Crime
2004,66207920,30000000,8,36207920,Action
2004,66207920,30000000,8,36207920,Crime
2004,66207920,30000000,8,36207920,Drama
2004,66207920,30000000,8,36207920,Thriller
2004,51225796,70000000,7.4,-18774204,Drama
2004,51225796,70000000,7.4,-18774204,Musical
2004,51225796,70000000,7.4,-18774204,Romance
2004,51225796,70000000,7.4,-18774204,Thriller
2004,6768055,57000000,4.2,-50231945,Action
2004,6768055,57000000,4.2,-50231945,Adventure
2004,6768055,57000000,4.2,-50231945,Comedy
2004,6768055,57000000,4.2,-50231945,Family
2004,6768055,57000000,4.2,-50231945,Sci-Fi
2004,6167817,47000000,7.7,-40832183,Drama
2004,6167817,47000000,7.7,-40832183,Mystery
2004,6167817,47000000,7.7,-40832183,Romance
2004,6167817,47000000,7.7,-40832183,War
2004,75367693,35000000,5,40367693,Animation
2004,75367693,35000000,5,40367693,Comedy
2004,75367693,35000000,5,40367693,Family
2004,75367693,35000000,5,40367693,Fantasy
2004,73701902,60000000,5.2,13701902,Comedy
2004,73701902,60000000,5.2,13701902,Family
2004,50740078,45000000,6.2,5740078,Action
2004,50740078,45000000,6.2,5740078,Horror
2004,50740078,45000000,6.2,5740078,Sci-Fi
2004,50740078,45000000,6.2,5740078,Thriller
2004,40203020,40000000,5.9,203020,Comedy
2004,40203020,40000000,5.9,203020,Drama
2004,40203020,40000000,5.9,203020,Romance
2004,37486138,50000000,6,-12513862,Comedy
2004,37486138,50000000,6,-12513862,Drama
2004,37486138,50000000,6,-12513862,Romance
2004,24006726,50000000,7.3,-25993274,Adventure
2004,24006726,50000000,7.3,-25993274,Comedy
2004,24006726,50000000,7.3,-25993274,Drama
2004,6471394,50000000,4.9,-43528606,Comedy
2004,6471394,50000000,4.9,-43528606,Crime
2004,95149435,40000000,5.7,55149435,Comedy
2004,95149435,40000000,5.7,55149435,Family
2004,95149435,40000000,5.7,55149435,Romance
2004,48114556,26000000,4.3,22114556,Comedy
2004,48114556,26000000,4.3,22114556,Family
2004,48114556,26000000,4.3,22114556,Fantasy
2004,48114556,26000000,4.3,22114556,Romance
2004,32003620,25000000,6.5,7003620,Action
2004,32003620,25000000,6.5,7003620,Crime
2004,32003620,25000000,6.5,7003620,Thriller
2004,87856565,42000000,5.9,45856565,Comedy
2004,87856565,42000000,5.9,45856565,Romance
2004,75305995,40000000,7.7,35305995,Biography
2004,75305995,40000000,7.7,35305995,Drama
2004,75305995,40000000,7.7,35305995,Music
2004,57887882,50000000,6.1,7887882,Comedy
2004,57887882,50000000,6.1,7887882,Drama
2004,57887882,50000000,6.1,7887882,Romance
2004,47781388,40000000,6.6,7781388,Mystery
2004,47781388,40000000,6.6,7781388,Thriller
2004,21176322,40000000,4,-18823678,Action
2004,21176322,40000000,4,-18823678,Comedy
2004,21176322,40000000,4,-18823678,Crime
2004,14018364,30000000,4.8,-15981636,Comedy
2004,14018364,30000000,4.8,-15981636,Crime
2004,14018364,30000000,4.8,-15981636,Family
2004,14018364,30000000,4.8,-15981636,Romance
2004,13395939,60000000,6.2,-46604061,Comedy
2004,13395939,60000000,6.2,-46604061,Drama
2004,13395939,60000000,6.2,-46604061,Romance
2004,5881504,39000000,5.3,-33118496,Biography
2004,5881504,39000000,5.3,-33118496,Drama
2004,5881504,39000000,5.3,-33118496,Romance
2004,5881504,39000000,5.3,-33118496,Sport
2004,39692139,35000000,6.2,4692139,Comedy
2004,39692139,35000000,6.2,4692139,Crime
2004,39692139,35000000,6.2,4692139,Thriller
2004,33987757,27000000,7.3,6987757,Drama
2004,33987757,27000000,7.3,6987757,Romance
2004,25266129,35000000,6.2,-9733871,Comedy
2004,25266129,35000000,6.2,-9733871,Drama
2004,25266129,35000000,6.2,-9733871,Romance
2004,22913677,35000000,6.3,-12086323,Comedy
2004,22913677,35000000,6.3,-12086323,Family
2004,22913677,35000000,6.3,-12086323,Fantasy
2004,22913677,35000000,6.3,-12086323,Romance
2004,16831505,31000000,6.3,-14168495,Comedy
2004,16831505,31000000,6.3,-14168495,Romance
2004,16831505,31000000,6.3,-14168495,Sport
2004,33682273,33000000,6.5,682273,Action
2004,33682273,33000000,6.5,682273,Crime
2004,33682273,33000000,6.5,682273,Drama
2004,33682273,33000000,6.5,682273,Thriller
2004,17848322,28000000,5.9,-10151678,Comedy
2004,17848322,28000000,5.9,-10151678,Romance
2004,114324072,20000000,6.7,94324072,Comedy
2004,114324072,20000000,6.7,94324072,Sport
2004,85416609,30000000,7,55416609,Adventure
2004,85416609,30000000,7,55416609,Animation
2004,85416609,30000000,7,55416609,Comedy
2004,85416609,30000000,7,55416609,Family
2004,85416609,30000000,7,55416609,Fantasy
2004,100422786,30000000,8.1,70422786,Drama
2004,100422786,30000000,8.1,70422786,Sport
2004,64286,29000000,7.9,-28935714,Drama
2004,64286,29000000,7.9,-28935714,Romance
2004,58156435,19000000,5.9,39156435,Adventure
2004,58156435,19000000,5.9,39156435,Comedy
2004,58156435,19000000,5.9,39156435,Mystery
2004,56044241,37000000,6.1,19044241,Comedy
2004,56044241,37000000,6.1,19044241,Fantasy
2004,56044241,37000000,6.1,19044241,Romance
2004,20422207,35000000,5.2,-14577793,Comedy
2004,20422207,35000000,5.2,-14577793,Drama
2004,20422207,35000000,5.2,-14577793,Romance
2004,21800302,30000000,5.5,-8199698,Comedy
2004,21800302,30000000,5.5,-8199698,Drama
2004,21800302,30000000,5.5,-8199698,Romance
2004,21800302,30000000,5.5,-8199698,Sport
2004,16323969,40000000,5.5,-23676031,Comedy
2004,16323969,40000000,5.5,-23676031,Crime
2004,16323969,40000000,5.5,-23676031,Thriller
2004,12831121,30000000,7,-17168879,Drama
2004,12831121,30000000,7,-17168879,Mystery
2004,12831121,30000000,7,-17168879,Romance
2004,12831121,30000000,7,-17168879,Thriller
2004,14334645,25000000,4.8,-10665355,Drama
2004,14334645,25000000,4.8,-10665355,Horror
2004,14334645,25000000,4.8,-10665355,Sci-Fi
2004,14334645,25000000,4.8,-10665355,Thriller
2004,12189514,23000000,6.1,-10810486,Comedy
2004,12189514,23000000,6.1,-10810486,Romance
2004,3752725,18000000,7.1,-14247275,Drama
2004,3752725,18000000,7.1,-14247275,Romance
2004,17016190,12000000,4.9,5016190,Comedy
2004,17016190,12000000,4.9,5016190,Fantasy
2004,17016190,12000000,4.9,5016190,Horror
2004,17016190,12000000,4.9,5016190,Thriller
2004,64371181,28000000,7.5,36371181,Biography
2004,64371181,28000000,7.5,36371181,Drama
2004,64371181,28000000,7.5,36371181,History
2004,64371181,28000000,7.5,36371181,Sport
2004,58885635,26000000,7.4,32885635,Action
2004,58885635,26000000,7.4,32885635,Horror
2004,58885635,26000000,7.4,32885635,Thriller
2004,8712564,27000000,5.9,-18287436,Crime
2004,8712564,27000000,5.9,-18287436,Drama
2004,8712564,27000000,5.9,-18287436,Mystery
2004,8712564,27000000,5.9,-18287436,Thriller
2004,4476235,27000000,6.4,-22523765,Crime
2004,4476235,27000000,6.4,-22523765,Horror
2004,4476235,27000000,6.4,-22523765,Mystery
2004,4476235,27000000,6.4,-22523765,Thriller
2004,45489752,26000000,6.5,19489752,Comedy
2004,45489752,26000000,6.5,19489752,Drama
2004,45489752,26000000,6.5,19489752,Romance
2004,23222861,26000000,4.5,-2777139,Action
2004,23222861,26000000,4.5,-2777139,Adventure
2004,23222861,26000000,4.5,-2777139,Comedy
2004,23222861,26000000,4.5,-2777139,Family
2004,23222861,26000000,4.5,-2777139,Romance
2004,23222861,26000000,4.5,-2777139,Sci-Fi
2004,14469428,26000000,5.2,-11530572,Comedy
2004,14469428,26000000,5.2,-11530572,Romance
2004,499263,30000000,7.1,-29500737,Drama
2004,84185387,80000000,4.9,4185387,Adventure
2004,84185387,80000000,4.9,4185387,Comedy
2004,84185387,80000000,4.9,4185387,Family
2004,84185387,80000000,4.9,4185387,Fantasy
2004,84185387,80000000,4.9,4185387,Horror
2004,84185387,80000000,4.9,4185387,Mystery
2004,51676606,25000000,7.8,26676606,Biography
2004,51676606,25000000,7.8,26676606,Drama
2004,51676606,25000000,7.8,26676606,Family
2004,84136909,26000000,7.2,58136909,Comedy
2004,31526393,25000000,4.6,6526393,Action
2004,31526393,25000000,4.6,6526393,Adventure
2004,31526393,25000000,4.6,6526393,Horror
2004,31526393,25000000,4.6,6526393,Thriller
2004,17718223,25000000,6.6,-7281777,Comedy
2004,14589444,25000000,6.8,-10410556,Comedy
2004,14589444,25000000,6.8,-10410556,Drama
2004,14589444,25000000,6.8,-10410556,Romance
2004,16964743,24000000,5.6,-7035257,Comedy
2004,16964743,24000000,5.6,-7035257,Romance
2004,6144806,23000000,6.7,-16855194,Biography
2004,6144806,23000000,6.7,-16855194,Drama
2004,6144806,23000000,6.7,-16855194,Music
2004,6144806,23000000,6.7,-16855194,Musical
2004,42880,24000000,5.1,-23957120,Drama
2004,42880,24000000,5.1,-23957120,Romance
2004,4710455,24000000,8.2,-19289545,Adventure
2004,4710455,24000000,8.2,-19289545,Animation
2004,4710455,24000000,8.2,-19289545,Family
2004,4710455,24000000,8.2,-19289545,Fantasy
2004,12189514,23000000,6.1,-10810486,Comedy
2004,12189514,23000000,6.1,-10810486,Romance
2004,16123851,23000000,6.2,-6876149,Drama
2004,12784713,22000000,6.7,-9215287,Comedy
2004,12831121,30000000,7,-17168879,Drama
2004,12831121,30000000,7,-17168879,Mystery
2004,12831121,30000000,7,-17168879,Romance
2004,12831121,30000000,7,-17168879,Thriller
2004,69148997,37000000,5.4,32148997,Comedy
2004,69148997,37000000,5.4,32148997,Crime
2004,32774834,30000000,7.2,2774834,Action
2004,32774834,30000000,7.2,2774834,Comedy
2004,34126138,20000000,8.3,14126138,Drama
2004,34126138,20000000,8.3,14126138,Fantasy
2004,34126138,20000000,8.3,14126138,Romance
2004,34126138,20000000,8.3,14126138,Sci-Fi
2004,17104669,20000000,7.8,-2895331,Action
2004,17104669,20000000,7.8,-2895331,Comedy
2004,17104669,20000000,7.8,-2895331,Crime
2004,17104669,20000000,7.8,-2895331,Fantasy
2004,15712072,20000000,5.8,-4287928,Action
2004,15712072,20000000,5.8,-4287928,Crime
2004,15712072,20000000,5.8,-4287928,Drama
2004,15712072,20000000,5.8,-4287928,Thriller
2004,12181484,40000000,4.8,-27818516,Comedy
2004,9109322,20000000,1.9,-10890678,Comedy
2004,9109322,20000000,1.9,-10890678,Family
2004,9109322,20000000,1.9,-10890678,Sci-Fi
2004,8054280,20000000,6.3,-11945720,Comedy
2004,8054280,20000000,6.3,-11945720,Crime
2004,8054280,20000000,6.3,-11945720,Music
2004,5005883,20000000,6.1,-14994117,Drama
2004,5005883,20000000,6.1,-14994117,Mystery
2004,5005883,20000000,6.1,-14994117,Romance
2004,5005883,20000000,6.1,-14994117,Thriller
2004,410388,2127519898,6.9,-2127109510,Action
2004,410388,2127519898,6.9,-2127109510,Adventure
2004,410388,2127519898,6.9,-2127109510,Animation
2004,410388,2127519898,6.9,-2127109510,Family
2004,410388,2127519898,6.9,-2127109510,Sci-Fi
2004,410388,2127519898,6.9,-2127109510,Thriller
2004,51431160,20000000,5.9,31431160,Comedy
2004,51431160,20000000,5.9,31431160,Family
2004,51431160,20000000,5.9,31431160,Romance
2004,64955956,18000000,5.7,46955956,Comedy
2004,64955956,18000000,5.7,46955956,Drama
2004,86049418,17000000,7,69049418,Comedy
2004,16702864,18000000,5.2,-1297136,Comedy
2004,16702864,18000000,5.2,-1297136,Crime
2004,7739049,18000000,7.1,-10260951,Comedy
2004,7739049,18000000,7.1,-10260951,Drama
2004,7739049,18000000,7.1,-10260951,Romance
2004,23472900,17500000,8.1,5972900,Drama
2004,23472900,17500000,8.1,5972900,History
2004,23472900,17500000,8.1,5972900,War
2004,71502303,12000000,7.5,59502303,Adventure
2004,71502303,12000000,7.5,59502303,Comedy
2004,71502303,12000000,7.5,59502303,Drama
2004,71502303,12000000,7.5,59502303,Romance
2004,13922211,16000000,4.4,-2077789,Comedy
2004,29302097,15000000,4.6,14302097,Comedy
2004,29302097,15000000,4.6,14302097,Family
2004,29302097,15000000,4.6,14302097,Music
2004,29302097,15000000,4.6,14302097,Romance
2004,13337299,20000000,6.6,-6662701,Biography
2004,13337299,20000000,6.6,-6662701,Drama
2004,13337299,20000000,6.6,-6662701,Music
2004,13337299,20000000,6.6,-6662701,Musical
2004,10411980,15000000,5.9,-4588020,Family
2004,10411980,15000000,5.9,-4588020,Music
2004,10411980,15000000,5.9,-4588020,Romance
2004,1197786,12000000,7.2,-10802214,Action
2004,1197786,12000000,7.2,-10802214,Crime
2004,1197786,12000000,7.2,-10802214,Thriller
2004,5501940,13500000,8.3,-7998060,Biography
2004,5501940,13500000,8.3,-7998060,Drama
2004,5501940,13500000,8.3,-7998060,History
2004,5501940,13500000,8.3,-7998060,War
2004,2086345,10000000,8.1,-7913655,Biography
2004,2086345,10000000,8.1,-7913655,Drama
2004,2086345,10000000,8.1,-7913655,Romance
2004,23947,13000000,7.7,-12976053,Sci-Fi
2004,23947,13000000,7.7,-12976053,Thriller
2004,1110186,12800000,8.1,-11689814,Action
2004,1110186,12800000,8.1,-11689814,Drama
2004,1110186,12800000,8.1,-11689814,War
2004,31179516,12000000,4.3,19179516,Comedy
2004,22406362,107000000,6,-84593638,Drama
2004,22406362,107000000,6,-84593638,History
2004,22406362,107000000,6,-84593638,War
2004,22406362,107000000,6,-84593638,Western
2004,11041228,100000000,7.6,-88958772,Action
2004,11041228,100000000,7.6,-88958772,Adventure
2004,11041228,100000000,7.6,-88958772,Drama
2004,11041228,100000000,7.6,-88958772,Romance
2004,261481,12000000,7.5,-11738519,Drama
2004,261481,12000000,7.5,-11738519,Romance
2004,261481,12000000,7.5,-11738519,Sci-Fi
2004,10214647,11000000,7.1,-785353,Biography
2004,10214647,11000000,7.1,-785353,Drama
2004,3753806,11000000,7.7,-7246194,Crime
2004,3753806,11000000,7.7,-7246194,Drama
2004,110175871,10000000,5.9,100175871,Horror
2004,110175871,10000000,5.9,100175871,Mystery
2004,110175871,10000000,5.9,100175871,Thriller
2004,8070311,10000000,5.3,-1929689,Comedy
2004,8070311,10000000,5.3,-1929689,Romance
2004,6491350,10000000,5.8,-3508650,Animation
2004,6491350,10000000,5.8,-3508650,Comedy
2004,6491350,10000000,5.8,-3508650,Family
2004,6491350,10000000,5.8,-3508650,Fantasy
2004,6491350,10000000,5.8,-3508650,Musical
2004,54557348,6500000,7.9,48057348,Crime
2004,54557348,6500000,7.9,48057348,Drama
2004,54557348,6500000,7.9,48057348,Thriller
2004,228524,4000000,7.3,-3771476,Comedy
2004,228524,4000000,7.3,-3771476,Drama
2004,70527,6500000,6.7,-6429473,Comedy
2004,70527,6500000,6.7,-6429473,Drama
2004,18225165,9000000,7.1,9225165,Adventure
2004,18225165,9000000,7.1,9225165,Comedy
2004,4992159,8550000,5.6,-3557841,Comedy
2004,4992159,8550000,5.6,-3557841,Horror
2004,4992159,8550000,5.6,-3557841,Thriller
2004,40066497,8000000,3.5,32066497,Drama
2004,40066497,8000000,3.5,32066497,Music
2004,23106,50000000,6.6,-49976894,Comedy
2004,23106,50000000,6.6,-49976894,Crime
2004,23106,50000000,6.6,-49976894,Drama
2004,23106,50000000,6.6,-49976894,Romance
2004,3347439,7500000,6.9,-4152561,Drama
2004,3347439,7500000,6.9,-4152561,Romance
2004,54557348,6500000,7.9,48057348,Crime
2004,54557348,6500000,7.9,48057348,Drama
2004,54557348,6500000,7.9,48057348,Thriller
2004,6601079,7000000,6.2,-398921,Comedy
2004,6601079,7000000,6.2,-398921,Drama
2004,6601079,7000000,6.2,-398921,Musical
2004,6601079,7000000,6.2,-398921,Romance
2004,2921738,7000000,7.9,-4078262,Drama
2004,2921738,7000000,7.9,-4078262,Musical
2004,2921738,7000000,7.9,-4078262,Romance
2004,2338695,4000000,7.4,-1661305,Crime
2004,2338695,4000000,7.4,-1661305,Drama
2004,2338695,4000000,7.4,-1661305,Thriller
2004,1029017,6500000,6.8,-5470983,Drama
2004,1029017,6500000,6.8,-5470983,Romance
2004,119078393,6000000,7.5,113078393,Documentary
2004,119078393,6000000,7.5,113078393,Drama
2004,119078393,6000000,7.5,113078393,War
2004,24004159,110000000,5.8,-85995841,Action
2004,24004159,110000000,5.8,-85995841,Adventure
2004,24004159,110000000,5.8,-85995841,Comedy
2004,3629758,5500000,7.9,-1870242,Drama
2004,3629758,5500000,7.9,-1870242,Music
2004,795126,6000000,7.6,-5204874,Comedy
2004,795126,6000000,7.6,-5204874,Drama
2004,795126,6000000,7.6,-5204874,Sport
2004,13464388,4000000,8,9464388,Comedy
2004,13464388,4000000,8,9464388,Horror
2004,8786715,5000000,6.9,3786715,Comedy
2004,8786715,5000000,6.9,3786715,Drama
2004,1082044,5000000,7.7,-3917956,Drama
2004,1082044,5000000,7.7,-3917956,Thriller
2004,16066,5000000,3.3,-4983934,Mystery
2004,16066,5000000,3.3,-4983934,Romance
2004,16066,5000000,3.3,-4983934,Thriller
2004,1487477,4200000,6.5,-2712523,Fantasy
2004,1487477,4200000,6.5,-2712523,Thriller
2004,96793,3500000,5.3,-3403207,Action
2004,96793,3500000,5.3,-3403207,Comedy
2004,96793,3500000,5.3,-3403207,Romance
2004,6517198,3000000,7.5,3517198,Crime
2004,6517198,3000000,7.5,3517198,Drama
2004,95016,2700000,7.4,-2604984,Comedy
2004,95016,2700000,7.4,-2604984,Drama
2004,95016,2700000,7.4,-2604984,Romance
2004,95016,2700000,7.4,-2604984,Sport
2004,26781723,2500000,7.6,24281723,Comedy
2004,26781723,2500000,7.6,24281723,Drama
2004,26781723,2500000,7.6,24281723,Romance
2004,114324072,20000000,6.7,94324072,Comedy
2004,114324072,20000000,6.7,94324072,Sport
2004,5792822,2700000,8,3092822,Drama
2004,5792822,2700000,8,3092822,Romance
2004,371081,6000000,7,-5628919,Comedy
2004,371081,6000000,7,-5628919,Drama
2004,992238,1700000,6.8,-707762,Drama
2004,992238,1700000,6.8,-707762,Romance
2004,396035,1000000,6.9,-603965,Drama
2004,396035,1000000,6.9,-603965,Romance
2004,58885635,26000000,7.4,32885635,Action
2004,58885635,26000000,7.4,32885635,Horror
2004,58885635,26000000,7.4,32885635,Thriller
2004,304124,1400000,6.7,-1095876,Drama
2004,36830,1400000,6.6,-1363170,Adventure
2004,36830,1400000,6.6,-1363170,Comedy
2004,36830,1400000,6.6,-1363170,Horror
2004,55153403,1200000,7.7,53953403,Horror
2004,55153403,1200000,7.7,53953403,Mystery
2004,55153403,1200000,7.7,53953403,Thriller
2004,6013,695393,7.7,-689380,Crime
2004,6013,695393,7.7,-689380,Drama
2004,6013,695393,7.7,-689380,Thriller
2004,603943,500000,7.3,103943,Crime
2004,603943,500000,7.3,103943,Drama
2004,9910,25000000,7.6,-24990090,Comedy
2004,9910,25000000,7.6,-24990090,Drama
2004,9910,25000000,7.6,-24990090,Music
2004,9910,25000000,7.6,-24990090,Romance
2004,44540956,400000,6.9,44140956,Comedy
2004,5199,200000,6.6,-194801,Drama
2004,5199,200000,6.6,-194801,Sport
2004,191309,150000,5.5,41309,Drama
2004,191309,150000,5.5,41309,Mystery
2004,191309,150000,5.5,41309,Thriller
2004,381225,200000,7.2,181225,Documentary
2004,11529368,65000,7.3,11464368,Comedy
2004,11529368,65000,7.3,11464368,Documentary
2004,11529368,65000,7.3,11464368,Drama
2004,136007,4500,6.9,131507,Drama
2004,136007,4500,6.9,131507,Music
2004,136007,4500,6.9,131507,Romance
2004,424760,7000,7,417760,Drama
2004,424760,7000,7,417760,Sci-Fi
2004,424760,7000,7,417760,Thriller
2004,85222,1100,6.6,84122,Documentary
2003,150350192,200000000,6.4,-49649808,Action
2003,150350192,200000000,6.4,-49649808,Sci-Fi
2003,139259759,150000000,6.7,-10740241,Action
2003,139259759,150000000,6.7,-10740241,Sci-Fi
2003,281492479,150000000,7.2,131492479,Action
2003,281492479,150000000,7.2,131492479,Sci-Fi
2003,111110575,140000000,7.7,-28889425,Action
2003,111110575,140000000,7.7,-28889425,Drama
2003,111110575,140000000,7.7,-28889425,History
2003,111110575,140000000,7.7,-28889425,War
2003,132122995,137000000,5.7,-4877005,Action
2003,132122995,137000000,5.7,-4877005,Sci-Fi
2003,93926386,150000000,7.4,-56073614,Action
2003,93926386,150000000,7.4,-56073614,Adventure
2003,93926386,150000000,7.4,-56073614,Drama
2003,93926386,150000000,7.4,-56073614,History
2003,93926386,150000000,7.4,-56073614,War
2003,138396624,130000000,6.6,8396624,Action
2003,138396624,130000000,6.6,8396624,Comedy
2003,138396624,130000000,6.6,8396624,Crime
2003,138396624,130000000,6.6,8396624,Thriller
2003,305388685,140000000,8.1,165388685,Action
2003,305388685,140000000,8.1,165388685,Adventure
2003,305388685,140000000,8.1,165388685,Fantasy
2003,214948780,110000000,7.5,104948780,Action
2003,214948780,110000000,7.5,104948780,Adventure
2003,214948780,110000000,7.5,104948780,Fantasy
2003,214948780,110000000,7.5,104948780,Sci-Fi
2003,214948780,110000000,7.5,104948780,Thriller
2003,100685880,120000000,4.8,-19314120,Action
2003,100685880,120000000,4.8,-19314120,Adventure
2003,100685880,120000000,4.8,-19314120,Comedy
2003,100685880,120000000,4.8,-19314120,Crime
2003,100446895,109000000,3.8,-8553105,Adventure
2003,100446895,109000000,3.8,-8553105,Comedy
2003,100446895,109000000,3.8,-8553105,Family
2003,100446895,109000000,3.8,-8553105,Fantasy
2003,380838870,94000000,8.2,286838870,Adventure
2003,380838870,94000000,8.2,286838870,Animation
2003,380838870,94000000,8.2,286838870,Comedy
2003,380838870,94000000,8.2,286838870,Family
2003,377019252,94000000,8.9,283019252,Action
2003,377019252,94000000,8.9,283019252,Adventure
2003,377019252,94000000,8.9,283019252,Drama
2003,377019252,94000000,8.9,283019252,Fantasy
2003,75817994,90000000,4.9,-14182006,Comedy
2003,75817994,90000000,4.9,-14182006,Family
2003,75817994,90000000,4.9,-14182006,Fantasy
2003,75817994,90000000,4.9,-14182006,Horror
2003,75817994,90000000,4.9,-14182006,Mystery
2003,65653758,95000000,5.5,-29346242,Action
2003,65653758,95000000,5.5,-29346242,Adventure
2003,65653758,95000000,5.5,-29346242,Fantasy
2003,120147445,87000000,7.3,33147445,Drama
2003,120147445,87000000,7.3,33147445,History
2003,120147445,87000000,7.3,33147445,Sport
2003,47592825,85000000,6.7,-37407175,Action
2003,47592825,85000000,6.7,-37407175,Adventure
2003,47592825,85000000,6.7,-37407175,Comedy
2003,47592825,85000000,6.7,-37407175,Thriller
2003,31111260,60000000,5.4,-28888740,Action
2003,31111260,60000000,5.4,-28888740,Adventure
2003,31111260,60000000,5.4,-28888740,Sci-Fi
2003,31111260,60000000,5.4,-28888740,Thriller
2003,242589580,81000000,6.7,161589580,Comedy
2003,242589580,81000000,6.7,161589580,Drama
2003,124590960,80000000,6.7,44590960,Comedy
2003,124590960,80000000,6.7,44590960,Drama
2003,124590960,80000000,6.7,44590960,Romance
2003,95632614,79000000,7.2,16632614,Adventure
2003,95632614,79000000,7.2,16632614,Drama
2003,95632614,79000000,7.2,16632614,History
2003,95632614,79000000,7.2,16632614,Romance
2003,95632614,79000000,7.2,16632614,War
2003,20950820,80000000,5.7,-59049180,Adventure
2003,20950820,80000000,5.7,-59049180,Animation
2003,20950820,80000000,5.7,-59049180,Comedy
2003,20950820,80000000,5.7,-59049180,Family
2003,20950820,80000000,5.7,-59049180,Fantasy
2003,20950820,80000000,5.7,-59049180,Sci-Fi
2003,19480739,80000000,5.6,-60519261,Action
2003,19480739,80000000,5.6,-60519261,Adventure
2003,19480739,80000000,5.6,-60519261,Sci-Fi
2003,127083765,76000000,5.9,51083765,Action
2003,127083765,76000000,5.9,51083765,Crime
2003,127083765,76000000,5.9,51083765,Thriller
2003,66462600,78000000,5.8,-11537400,Action
2003,66462600,78000000,5.8,-11537400,Adventure
2003,66462600,78000000,5.8,-11537400,Fantasy
2003,66462600,78000000,5.8,-11537400,Sci-Fi
2003,43426961,70000000,6.6,-26573039,Action
2003,43426961,70000000,6.6,-26573039,Drama
2003,43426961,70000000,6.6,-26573039,Thriller
2003,43426961,70000000,6.6,-26573039,War
2003,30013346,75000000,5.3,-44986654,Action
2003,30013346,75000000,5.3,-44986654,Comedy
2003,30013346,75000000,5.3,-44986654,Crime
2003,30013346,75000000,5.3,-44986654,Thriller
2003,116643346,80000000,6,36643346,Action
2003,116643346,80000000,6,36643346,Adventure
2003,116643346,80000000,6,36643346,Crime
2003,116643346,80000000,6,36643346,Thriller
2003,66257002,70000000,8,-3742998,Adventure
2003,66257002,70000000,8,-3742998,Drama
2003,66257002,70000000,8,-3742998,Fantasy
2003,33685268,68000000,5.5,-34314732,Drama
2003,33685268,68000000,5.5,-34314732,Horror
2003,33685268,68000000,5.5,-34314732,Sci-Fi
2003,33685268,68000000,5.5,-34314732,Thriller
2003,63695760,65000000,6.4,-1304240,Drama
2003,104148781,60000000,5.5,44148781,Comedy
2003,104148781,60000000,5.5,44148781,Family
2003,106126012,60000000,7,46126012,Action
2003,106126012,60000000,7,46126012,Crime
2003,106126012,60000000,7,46126012,Thriller
2003,66734992,60000000,4.4,6734992,Action
2003,66734992,60000000,4.4,6734992,Adventure
2003,66734992,60000000,4.4,6734992,Comedy
2003,66734992,60000000,4.4,6734992,Crime
2003,53789313,60000000,6.3,-6210687,Action
2003,53789313,60000000,6.3,-6210687,Mystery
2003,53789313,60000000,6.3,-6210687,Sci-Fi
2003,53789313,60000000,6.3,-6210687,Thriller
2003,35096190,60000000,6.3,-24903810,Comedy
2003,35096190,60000000,6.3,-24903810,Crime
2003,35096190,60000000,6.3,-24903810,Romance
2003,26288320,60000000,6.7,-33711680,Adventure
2003,26288320,60000000,6.7,-33711680,Animation
2003,26288320,60000000,6.7,-33711680,Comedy
2003,26288320,60000000,6.7,-33711680,Drama
2003,26288320,60000000,6.7,-33711680,Family
2003,26288320,60000000,6.7,-33711680,Fantasy
2003,26288320,60000000,6.7,-33711680,Romance
2003,4426297,35000000,6.5,-30573703,Adventure
2003,4426297,35000000,6.5,-30573703,Drama
2003,4426297,35000000,6.5,-30573703,Romance
2003,4426297,35000000,6.5,-30573703,War
2003,104354205,55000000,6.3,49354205,Comedy
2003,104354205,55000000,6.3,49354205,Romance
2003,70098138,30000000,8.1,40098138,Action
2003,34238611,55000000,6,-20761389,Action
2003,34238611,55000000,6,-20761389,Crime
2003,34238611,55000000,6,-20761389,Drama
2003,34238611,55000000,6,-20761389,Thriller
2003,33828318,55000000,5.8,-21171682,Comedy
2003,12870569,56000000,6.3,-43129431,Drama
2003,12870569,56000000,6.3,-43129431,History
2003,12870569,56000000,6.3,-43129431,War
2003,5660084,54000000,2.4,-48339916,Comedy
2003,5660084,54000000,2.4,-48339916,Crime
2003,5660084,54000000,2.4,-48339916,Romance
2003,23020488,52000000,5.5,-28979512,Action
2003,23020488,52000000,5.5,-28979512,Comedy
2003,23020488,52000000,5.5,-28979512,Fantasy
2003,105807520,50000000,6.4,55807520,Comedy
2003,105807520,50000000,6.4,55807520,Romance
2003,60470220,50000000,6.2,10470220,Action
2003,60470220,50000000,6.2,10470220,Adventure
2003,60470220,50000000,6.2,10470220,Comedy
2003,40905277,50000000,6.5,-9094723,Crime
2003,40905277,50000000,6.5,-9094723,Drama
2003,40905277,50000000,6.5,-9094723,Romance
2003,40905277,50000000,6.5,-9094723,Thriller
2003,26536120,50000000,6.5,-23463880,Action
2003,26536120,50000000,6.5,-23463880,Crime
2003,26536120,50000000,6.5,-23463880,Drama
2003,26536120,50000000,6.5,-23463880,Mystery
2003,26536120,50000000,6.5,-23463880,Thriller
2003,19593740,50000000,7.5,-30406260,Crime
2003,19593740,50000000,7.5,-30406260,Drama
2003,19593740,50000000,7.5,-30406260,Thriller
2003,110000082,48000000,5.5,62000082,Comedy
2003,59365105,45000000,7.7,14365105,Comedy
2003,59365105,45000000,7.7,14365105,Drama
2003,59365105,45000000,7.7,14365105,Romance
2003,27972410,35000000,6.1,-7027590,Action
2003,27972410,35000000,6.1,-7027590,Adventure
2003,27972410,35000000,6.1,-7027590,Comedy
2003,22108977,41000000,5.2,-18891023,Action
2003,22108977,41000000,5.2,-18891023,Comedy
2003,22108977,41000000,5.2,-18891023,Fantasy
2003,111760631,38000000,4.1,73760631,Action
2003,111760631,38000000,4.1,73760631,Adventure
2003,111760631,38000000,4.1,73760631,Comedy
2003,111760631,38000000,4.1,73760631,Family
2003,111760631,38000000,4.1,73760631,Sci-Fi
2003,138614544,40000000,5.8,98614544,Comedy
2003,138614544,40000000,5.8,98614544,Family
2003,59588068,40000000,5.8,19588068,Horror
2003,59588068,40000000,5.8,19588068,Mystery
2003,59588068,40000000,5.8,19588068,Thriller
2003,9652000,40000000,5.8,-30348000,Comedy
2003,26183197,36000000,6.1,-9816803,Action
2003,26183197,36000000,6.1,-9816803,Crime
2003,26183197,36000000,6.1,-9816803,Drama
2003,26183197,36000000,6.1,-9816803,Thriller
2003,37788228,35200000,5.4,2588228,Comedy
2003,52277485,35000000,6.9,17277485,Biography
2003,52277485,35000000,6.9,17277485,Drama
2003,52277485,35000000,6.9,17277485,Sport
2003,7659747,38000000,5.1,-30340253,Action
2003,7659747,38000000,5.1,-30340253,Mystery
2003,7659747,38000000,5.1,-30340253,Thriller
2003,173381405,33000000,6.9,140381405,Comedy
2003,173381405,33000000,6.9,140381405,Family
2003,173381405,33000000,6.9,140381405,Fantasy
2003,173381405,33000000,6.9,140381405,Romance
2003,90135191,25000000,8,65135191,Crime
2003,90135191,25000000,8,65135191,Drama
2003,90135191,25000000,8,65135191,Mystery
2003,90135191,25000000,8,65135191,Thriller
2003,41407470,30000000,7.6,11407470,Comedy
2003,41407470,30000000,7.6,11407470,Drama
2003,41407470,30000000,7.6,11407470,Family
2003,26096584,19000000,3.4,7096584,Comedy
2003,14208384,30000000,5.6,-15791616,Comedy
2003,14208384,30000000,5.6,-15791616,Romance
2003,55845943,29000000,6.4,26845943,Action
2003,55845943,29000000,6.4,26845943,Crime
2003,55845943,29000000,6.4,26845943,Thriller
2003,51475962,30000000,7.3,21475962,Mystery
2003,51475962,30000000,7.3,21475962,Thriller
2003,763044,23000000,6.2,-22236956,Drama
2003,763044,23000000,6.2,-22236956,Thriller
2003,110222438,26000000,6.1,84222438,Comedy
2003,110222438,26000000,6.1,84222438,Family
2003,110222438,26000000,6.1,84222438,Fantasy
2003,110222438,26000000,6.1,84222438,Music
2003,110222438,26000000,6.1,84222438,Romance
2003,58328680,22000000,7.5,36328680,Drama
2003,58328680,22000000,7.5,36328680,Romance
2003,58328680,22000000,7.5,36328680,Western
2003,46455802,26000000,6.2,20455802,Horror
2003,46455802,26000000,6.2,20455802,Thriller
2003,82163317,30000000,5.8,52163317,Action
2003,82163317,30000000,5.8,52163317,Horror
2003,82163317,30000000,5.8,52163317,Thriller
2003,89808372,45000000,4.6,44808372,Comedy
2003,47285499,26000000,5,21285499,Action
2003,47285499,26000000,5,21285499,Adventure
2003,47285499,26000000,5,21285499,Comedy
2003,47285499,26000000,5,21285499,Crime
2003,47285499,26000000,5,21285499,Family
2003,47285499,26000000,5,21285499,Romance
2003,47285499,26000000,5,21285499,Thriller
2003,39399750,25000000,5.6,14399750,Adventure
2003,39399750,25000000,5.6,14399750,Animation
2003,39399750,25000000,5.6,14399750,Comedy
2003,39399750,25000000,5.6,14399750,Family
2003,39399750,25000000,5.6,14399750,Fantasy
2003,39399750,25000000,5.6,14399750,Musical
2003,35990505,20000000,5.8,15990505,Comedy
2003,35990505,20000000,5.8,15990505,Drama
2003,35990505,20000000,5.8,15990505,Family
2003,35990505,20000000,5.8,15990505,Romance
2003,35143332,17000000,5.6,18143332,Horror
2003,34604054,30000000,5.8,4604054,Action
2003,34604054,30000000,5.8,4604054,Crime
2003,34604054,30000000,5.8,4604054,Drama
2003,34604054,30000000,5.8,4604054,Thriller
2003,74608545,24000000,7.2,50608545,Comedy
2003,51483949,22000000,7,29483949,Action
2003,51483949,22000000,7,29483949,Fantasy
2003,51483949,22000000,7,29483949,Thriller
2003,132541238,33000000,5.5,99541238,Comedy
2003,81257845,35000000,7.1,46257845,Comedy
2003,81257845,35000000,7.1,46257845,Music
2003,67325559,20000000,7.1,47325559,Adventure
2003,67325559,20000000,7.1,47325559,Comedy
2003,67325559,20000000,7.1,47325559,Drama
2003,67325559,20000000,7.1,47325559,Family
2003,67325559,20000000,7.1,47325559,Mystery
2003,47887943,20000000,5.4,27887943,Adventure
2003,47887943,20000000,5.4,27887943,Animation
2003,47887943,20000000,5.4,27887943,Family
2003,47887943,20000000,5.4,27887943,Musical
2003,16248701,20000000,7.7,-3751299,Drama
2003,15408822,20000000,5.6,-4591178,Comedy
2003,15408822,20000000,5.6,-4591178,Romance
2003,6852144,22000000,6.2,-15147856,Drama
2003,6852144,22000000,6.2,-15147856,Horror
2003,6852144,22000000,6.2,-15147856,Sci-Fi
2003,6852144,22000000,6.2,-15147856,Thriller
2003,2353728,20000000,6.9,-17646272,Comedy
2003,2353728,20000000,6.9,-17646272,Drama
2003,2353728,20000000,6.9,-17646272,Mystery
2003,2353728,20000000,6.9,-17646272,Romance
2003,2353728,20000000,6.9,-17646272,Thriller
2003,2353728,20000000,6.9,-17646272,War
2003,1646664,20000000,2.8,-18353336,Comedy
2003,1646664,20000000,2.8,-18353336,Music
2003,56127162,18000000,5.4,38127162,Comedy
2003,56127162,18000000,5.4,38127162,Romance
2003,60057639,18000000,7.1,42057639,Comedy
2003,60057639,18000000,7.1,42057639,Crime
2003,60057639,18000000,7.1,42057639,Drama
2003,43601508,18000000,6.7,25601508,Comedy
2003,43601508,18000000,6.7,25601508,Drama
2003,43601508,18000000,6.7,25601508,Romance
2003,30222640,25000000,5.3,5222640,Drama
2003,30222640,25000000,5.3,5222640,Music
2003,30222640,25000000,5.3,5222640,Romance
2003,3203044,18000000,6.4,-14796956,Comedy
2003,3203044,18000000,6.4,-14796956,Romance
2003,37566230,17000000,5.1,20566230,Comedy
2003,37566230,17000000,5.1,20566230,Drama
2003,37566230,17000000,5.1,20566230,Family
2003,37566230,17000000,5.1,20566230,Fantasy
2003,37566230,17000000,5.1,20566230,Sci-Fi
2003,22734486,17000000,5.6,5734486,Comedy
2003,1569918,17000000,6.9,-15430082,Biography
2003,1569918,17000000,6.9,-15430082,Crime
2003,1569918,17000000,6.9,-15430082,Drama
2003,1569918,17000000,6.9,-15430082,Thriller
2003,13005485,15000000,7.6,-1994515,Drama
2003,14108518,16000000,5.7,-1891482,Comedy
2003,14108518,16000000,5.7,-1891482,Drama
2003,14108518,16000000,5.7,-1891482,Romance
2003,42672630,17000000,5.3,25672630,Adventure
2003,42672630,17000000,5.3,25672630,Comedy
2003,42672630,17000000,5.3,25672630,Family
2003,42672630,17000000,5.3,25672630,Music
2003,42672630,17000000,5.3,25672630,Romance
2003,34308901,16000000,5.1,18308901,Comedy
2003,34308901,16000000,5.1,18308901,Crime
2003,12212417,15000000,6.7,-2787583,Crime
2003,12212417,15000000,6.7,-2787583,Thriller
2003,15549702,14000000,4.6,1549702,Comedy
2003,15549702,14000000,4.6,1549702,Romance
2003,4922166,12000000,2.1,-7077834,Comedy
2003,4922166,12000000,2.1,-7077834,Musical
2003,4922166,12000000,2.1,-7077834,Romance
2003,4717455,12000000,5.3,-7282545,Mystery
2003,4717455,12000000,5.3,-7282545,Thriller
2003,4068087,17000000,7.7,-12931913,Biography
2003,4068087,17000000,7.7,-12931913,Drama
2003,4068087,17000000,7.7,-12931913,History
2003,15417771,12600000,6.1,2817771,Horror
2003,15417771,12600000,6.1,2817771,Thriller
2003,1011054,10000000,7.2,-8988946,Crime
2003,1011054,10000000,7.2,-8988946,Drama
2003,1011054,10000000,7.2,-8988946,Thriller
2003,365734,10000000,5,-9634266,Drama
2003,336456,8000000,5.6,-7663544,Comedy
2003,336456,8000000,5.6,-7663544,Crime
2003,336456,8000000,5.6,-7663544,Musical
2003,336456,8000000,5.6,-7663544,Mystery
2003,197148,7500000,6.3,-7302852,Drama
2003,197148,7500000,6.3,-7302852,Romance
2003,197148,7500000,6.3,-7302852,Sci-Fi
2003,197148,7500000,6.3,-7302852,Thriller
2003,32131483,11000000,4.9,21131483,Horror
2003,32131483,11000000,4.9,21131483,Mystery
2003,32131483,11000000,4.9,21131483,Thriller
2003,12583510,7000000,6,5583510,Horror
2003,10696,6800000,6.4,-6789304,Crime
2003,10696,6800000,6.4,-6789304,Thriller
2003,223878,5000000,6.5,-4776122,Comedy
2003,223878,5000000,6.5,-4776122,Drama
2003,223878,5000000,6.5,-4776122,Romance
2003,4063859,4800000,7.7,-736141,Drama
2003,4063859,4800000,7.7,-736141,Romance
2003,2207975,6000000,7.2,-3792025,Drama
2003,2207975,6000000,7.2,-3792025,History
2003,6239558,5000000,6.7,1239558,Comedy
2003,6239558,5000000,6.7,1239558,Drama
2003,1056102,5000000,6.6,-3943898,Crime
2003,1056102,5000000,6.6,-3943898,Drama
2003,1056102,5000000,6.6,-3943898,Mystery
2003,1056102,5000000,6.6,-3943898,Thriller
2003,34468224,4500000,7.3,29968224,Biography
2003,34468224,4500000,7.3,29968224,Crime
2003,34468224,4500000,7.3,29968224,Drama
2003,34468224,4500000,7.3,29968224,Thriller
2003,3432342,6000000,7.7,-2567658,Comedy
2003,3432342,6000000,7.7,-2567658,Crime
2003,3432342,6000000,7.7,-2567658,Drama
2003,3432342,6000000,7.7,-2567658,Mystery
2003,3432342,6000000,7.7,-2567658,Romance
2003,296665,5000000,6.3,-4703335,Biography
2003,296665,5000000,6.3,-4703335,Crime
2003,296665,5000000,6.3,-4703335,Drama
2003,296665,5000000,6.3,-4703335,Thriller
2003,44566004,4000000,7.8,40566004,Drama
2003,8243880,3200000,7,5043880,Crime
2003,8243880,3200000,7,5043880,Drama
2003,8243880,3200000,7,5043880,Fantasy
2003,8243880,3200000,7,5043880,Romance
2003,3713002,8000000,2.7,-4286998,Documentary
2003,2223990,3000000,6.6,-776010,Comedy
2003,2223990,3000000,6.6,-776010,Documentary
2003,2181290,3000000,8.4,-818710,Drama
2003,2181290,3000000,8.4,-818710,Mystery
2003,2181290,3000000,8.4,-818710,Thriller
2003,3645438,2200000,6.8,1445438,Horror
2003,395592,2000000,7.6,-1604408,Drama
2003,395592,2000000,7.6,-1604408,Romance
2003,7002255,9500000,7.8,-2497745,Animation
2003,7002255,9500000,7.8,-2497745,Comedy
2003,7002255,9500000,7.8,-2497745,Drama
2003,4599680,1500000,6.8,3099680,Drama
2003,1098224,2000000,3.3,-901776,Adventure
2003,1420578,1900000,6.4,-479422,Drama
2003,1420578,1900000,6.4,-479422,Fantasy
2003,505295,1800000,7.5,-1294705,Adventure
2003,505295,1800000,7.5,-1294705,Drama
2003,2580,1650000,5.4,-1647420,Drama
2003,2580,1650000,5.4,-1647420,Mystery
2003,19539,1000000,6.2,-980461,Comedy
2003,548712,2500000,6.9,-1951288,Drama
2003,548712,2500000,6.9,-1951288,Romance
2003,279282,1000000,6.1,-720718,Comedy
2003,279282,1000000,6.1,-720718,Drama
2003,279282,1000000,6.1,-720718,Romance
2003,819939,850000,7.2,-30061,Comedy
2003,819939,850000,7.2,-30061,Drama
2003,819939,850000,7.2,-30061,Romance
2003,1310270,780000,6.8,530270,Action
2003,1310270,780000,6.8,530270,Adventure
2003,1310270,780000,6.8,530270,Drama
2003,1310270,780000,6.8,530270,War
2003,30500882,500000,5.7,30000882,Adventure
2003,30500882,500000,5.7,30000882,Biography
2003,30500882,500000,5.7,30000882,Drama
2003,30500882,500000,5.7,30000882,Horror
2003,30500882,500000,5.7,30000882,Thriller
2003,5739376,500000,7.7,5239376,Comedy
2003,5739376,500000,7.7,5239376,Drama
2003,1127331,46000,7.4,1081331,Drama
2003,1111615,500000,6,611615,Comedy
2003,1111615,500000,6,611615,Crime
2003,1111615,500000,6,611615,Family
2003,11798,100000,4.7,-88202,Comedy
2003,11798,100000,4.7,-88202,Fantasy
2003,11798,100000,4.7,-88202,Horror
2003,11798,100000,4.7,-88202,Musical
2003,592014,218,7.2,591796,Biography
2003,592014,218,7.2,591796,Documentary
2003,2360184,300000,7.1,2060184,Comedy
2003,2360184,300000,7.1,2060184,Drama
2002,160201106,142000000,6.1,18201106,Action
2002,160201106,142000000,6.1,18201106,Adventure
2002,160201106,142000000,6.1,18201106,Thriller
2002,190418803,140000000,6.1,50418803,Action
2002,190418803,140000000,6.1,50418803,Adventure
2002,190418803,140000000,6.1,50418803,Comedy
2002,190418803,140000000,6.1,50418803,Family
2002,190418803,140000000,6.1,50418803,Fantasy
2002,190418803,140000000,6.1,50418803,Mystery
2002,190418803,140000000,6.1,50418803,Sci-Fi
2002,403706375,139000000,7.3,264706375,Action
2002,403706375,139000000,7.3,264706375,Adventure
2002,403706375,139000000,7.3,264706375,Fantasy
2002,403706375,139000000,7.3,264706375,Romance
2002,64736114,120000000,5.4,-55263886,Adventure
2002,64736114,120000000,5.4,-55263886,Animation
2002,64736114,120000000,5.4,-55263886,Comedy
2002,64736114,120000000,5.4,-55263886,Family
2002,64736114,120000000,5.4,-55263886,Fantasy
2002,310675583,115000000,6.7,195675583,Action
2002,310675583,115000000,6.7,195675583,Adventure
2002,310675583,115000000,6.7,195675583,Fantasy
2002,310675583,115000000,6.7,195675583,Sci-Fi
2002,40911830,115000000,6,-74088170,Action
2002,40911830,115000000,6,-74088170,Drama
2002,40911830,115000000,6,-74088170,War
2002,132014112,102000000,7.7,30014112,Action
2002,132014112,102000000,7.7,30014112,Mystery
2002,132014112,102000000,7.7,30014112,Sci-Fi
2002,132014112,102000000,7.7,30014112,Thriller
2002,261970615,100000000,7.4,161970615,Adventure
2002,261970615,100000000,7.4,161970615,Family
2002,261970615,100000000,7.4,161970615,Fantasy
2002,261970615,100000000,7.4,161970615,Mystery
2002,38120554,140000000,7.1,-101879446,Adventure
2002,38120554,140000000,7.1,-101879446,Animation
2002,38120554,140000000,7.1,-101879446,Family
2002,38120554,140000000,7.1,-101879446,Sci-Fi
2002,4411102,100000000,3.8,-95588898,Action
2002,4411102,100000000,3.8,-95588898,Comedy
2002,4411102,100000000,3.8,-95588898,Sci-Fi
2002,77679638,100000000,7.5,-22320362,Crime
2002,77679638,100000000,7.5,-22320362,Drama
2002,340478898,94000000,8.7,246478898,Action
2002,340478898,94000000,8.7,246478898,Adventure
2002,340478898,94000000,8.7,246478898,Drama
2002,340478898,94000000,8.7,246478898,Fantasy
2002,35168677,100000000,6.7,-64831323,Drama
2002,35168677,100000000,6.7,-64831323,History
2002,35168677,100000000,6.7,-64831323,Thriller
2002,35168677,100000000,6.7,-64831323,War
2002,40048332,85000000,5.5,-44951668,Action
2002,40048332,85000000,5.5,-44951668,Drama
2002,40048332,85000000,5.5,-44951668,Thriller
2002,153288182,84000000,4.9,69288182,Adventure
2002,153288182,84000000,4.9,69288182,Comedy
2002,153288182,84000000,4.9,69288182,Mystery
2002,145771527,80000000,7.2,65771527,Adventure
2002,145771527,80000000,7.2,65771527,Animation
2002,145771527,80000000,7.2,65771527,Comedy
2002,145771527,80000000,7.2,65771527,Drama
2002,145771527,80000000,7.2,65771527,Family
2002,145771527,80000000,7.2,65771527,Fantasy
2002,145771527,80000000,7.2,65771527,Sci-Fi
2002,104054514,80000000,7.7,24054514,Crime
2002,104054514,80000000,7.7,24054514,Drama
2002,104054514,80000000,7.7,24054514,Thriller
2002,73215310,80000000,7,-6784690,Adventure
2002,73215310,80000000,7,-6784690,Animation
2002,73215310,80000000,7,-6784690,Family
2002,73215310,80000000,7,-6784690,Western
2002,56684819,80000000,5.9,-23315181,Action
2002,56684819,80000000,5.9,-23315181,Adventure
2002,56684819,80000000,5.9,-23315181,Sci-Fi
2002,92930005,78000000,7.2,14930005,Crime
2002,92930005,78000000,7.2,14930005,Drama
2002,92930005,78000000,7.2,14930005,Thriller
2002,227965690,72000000,6.7,155965690,Drama
2002,227965690,72000000,6.7,155965690,Sci-Fi
2002,227965690,72000000,6.7,155965690,Thriller
2002,141204016,70000000,5.8,71204016,Action
2002,141204016,70000000,5.8,71204016,Adventure
2002,141204016,70000000,5.8,71204016,Thriller
2002,78120196,75000000,7.1,3120196,Action
2002,78120196,75000000,7.1,3120196,Drama
2002,78120196,75000000,7.1,3120196,History
2002,78120196,75000000,7.1,3120196,War
2002,30157016,70000000,5.6,-39842984,Action
2002,30157016,70000000,5.6,-39842984,Adventure
2002,30157016,70000000,5.6,-39842984,Comedy
2002,30157016,70000000,5.6,-39842984,Thriller
2002,33105600,70000000,5.4,-36894400,Action
2002,33105600,70000000,5.4,-36894400,Adventure
2002,33105600,70000000,5.4,-36894400,Comedy
2002,33105600,70000000,5.4,-36894400,Thriller
2002,19076815,60000000,6.3,-40923185,Drama
2002,19076815,60000000,6.3,-40923185,War
2002,18990542,70000000,3,-51009458,Action
2002,18990542,70000000,3,-51009458,Sci-Fi
2002,18990542,70000000,3,-51009458,Sport
2002,14294842,70000000,3.6,-55705158,Action
2002,14294842,70000000,3.6,-55705158,Crime
2002,14294842,70000000,3.6,-55705158,Sci-Fi
2002,14294842,70000000,3.6,-55705158,Thriller
2002,118471320,68000000,6.4,50471320,Action
2002,118471320,68000000,6.4,50471320,Drama
2002,118471320,68000000,6.4,50471320,Thriller
2002,176387405,59000000,7.6,117387405,Adventure
2002,176387405,59000000,7.6,117387405,Animation
2002,176387405,59000000,7.6,117387405,Comedy
2002,176387405,59000000,7.6,117387405,Family
2002,139225854,60000000,5.5,79225854,Comedy
2002,139225854,60000000,5.5,79225854,Family
2002,139225854,60000000,5.5,79225854,Fantasy
2002,213079163,63000000,6.2,150079163,Action
2002,213079163,63000000,6.2,150079163,Comedy
2002,213079163,63000000,6.2,150079163,Crime
2002,121468960,60000000,7.9,61468960,Action
2002,121468960,60000000,7.9,61468960,Mystery
2002,121468960,60000000,7.9,61468960,Thriller
2002,93307796,60000000,6.1,33307796,Comedy
2002,93307796,60000000,6.1,33307796,Romance
2002,90341670,60000000,5.5,30341670,Action
2002,90341670,60000000,5.5,30341670,Adventure
2002,90341670,60000000,5.5,30341670,Fantasy
2002,90341670,60000000,5.5,30341670,Thriller
2002,50189179,60000000,5.3,-9810821,Action
2002,50189179,60000000,5.3,-9810821,Comedy
2002,50189179,60000000,5.3,-9810821,Sci-Fi
2002,43060566,60000000,6.2,-16939434,Action
2002,43060566,60000000,6.2,-16939434,Adventure
2002,43060566,60000000,6.2,-16939434,Fantasy
2002,43060566,60000000,6.2,-16939434,Sci-Fi
2002,43060566,60000000,6.2,-16939434,Thriller
2002,43119879,60000000,6.4,-16880121,Action
2002,43119879,60000000,6.4,-16880121,Adventure
2002,43119879,60000000,6.4,-16880121,Sci-Fi
2002,43119879,60000000,6.4,-16880121,Thriller
2002,32122249,60000000,5.9,-27877751,Comedy
2002,32122249,60000000,5.9,-27877751,Crime
2002,30063805,60000000,6.1,-29936195,Drama
2002,30063805,60000000,6.1,-29936195,Fantasy
2002,30063805,60000000,6.1,-29936195,Mystery
2002,30063805,60000000,6.1,-29936195,Romance
2002,30063805,60000000,6.1,-29936195,Thriller
2002,93815117,55000000,5.1,38815117,Comedy
2002,93815117,55000000,5.1,38815117,Drama
2002,93815117,55000000,5.1,38815117,Romance
2002,81645152,54000000,6.7,27645152,Action
2002,81645152,54000000,6.7,27645152,Horror
2002,81645152,54000000,6.7,27645152,Sci-Fi
2002,81645152,54000000,6.7,27645152,Thriller
2002,164435221,52000000,8,112435221,Biography
2002,164435221,52000000,8,112435221,Crime
2002,164435221,52000000,8,112435221,Drama
2002,126203320,50000000,5.8,76203320,Comedy
2002,126203320,50000000,5.8,76203320,Romance
2002,52752475,50000000,6.7,2752475,Drama
2002,52752475,50000000,6.7,2752475,Thriller
2002,31874869,50000000,6.1,-18125131,Crime
2002,31874869,50000000,6.1,-18125131,Mystery
2002,31874869,50000000,6.1,-18125131,Thriller
2002,26199517,50000000,6.4,-23800483,Action
2002,26199517,50000000,6.4,-23800483,Crime
2002,26199517,50000000,6.4,-23800483,Drama
2002,26199517,50000000,6.4,-23800483,Mystery
2002,26199517,50000000,6.4,-23800483,Thriller
2002,8355815,55000000,6.4,-46644185,Comedy
2002,8355815,55000000,6.4,-46644185,Crime
2002,8355815,55000000,6.4,-46644185,Drama
2002,8355815,55000000,6.4,-46644185,Thriller
2002,95308367,48000000,6.8,47308367,Crime
2002,95308367,48000000,6.8,47308367,Drama
2002,95308367,48000000,6.8,47308367,Thriller
2002,67263182,46000000,7.2,21263182,Drama
2002,67263182,46000000,7.2,21263182,Mystery
2002,67263182,46000000,7.2,21263182,Thriller
2002,66790248,45000000,6.5,21790248,Drama
2002,66790248,45000000,6.5,21790248,Thriller
2002,7262288,40000000,6.5,-32737712,Comedy
2002,7262288,40000000,6.5,-32737712,Crime
2002,7262288,40000000,6.5,-32737712,Thriller
2002,24430272,43000000,5.1,-18569728,Comedy
2002,24430272,43000000,5.1,-18569728,Romance
2002,41543207,42000000,6.3,-456793,Crime
2002,41543207,42000000,6.3,-456793,Drama
2002,41543207,42000000,6.3,-456793,Mystery
2002,41543207,42000000,6.3,-456793,Thriller
2002,35228696,32000000,6.5,3228696,Drama
2002,35228696,32000000,6.5,3228696,Horror
2002,35228696,32000000,6.5,3228696,Mystery
2002,35228696,32000000,6.5,3228696,Thriller
2002,84961,31000000,7.9,-30915039,Action
2002,84961,31000000,7.9,-30915039,Adventure
2002,84961,31000000,7.9,-30915039,History
2002,116724075,41000000,7,75724075,Drama
2002,116724075,41000000,7,75724075,Music
2002,54228104,35000000,7.7,19228104,Action
2002,54228104,35000000,7.7,19228104,Adventure
2002,54228104,35000000,7.7,19228104,Drama
2002,54228104,35000000,7.7,19228104,Romance
2002,54228104,35000000,7.7,19228104,Thriller
2002,22433915,60000000,6.2,-37566085,Crime
2002,22433915,60000000,6.2,-37566085,Drama
2002,22433915,60000000,6.2,-37566085,Mystery
2002,22433915,60000000,6.2,-37566085,Thriller
2002,14448589,40000000,5.8,-25551411,Comedy
2002,14448589,40000000,5.8,-25551411,Romance
2002,13208023,42000000,3.3,-28791977,Crime
2002,13208023,42000000,3.3,-28791977,Horror
2002,13208023,42000000,3.3,-28791977,Thriller
2002,4835968,40000000,4.5,-35164032,Action
2002,4835968,40000000,4.5,-35164032,Adventure
2002,4835968,40000000,4.5,-35164032,Thriller
2002,127214072,38000000,6.1,89214072,Comedy
2002,127214072,38000000,6.1,89214072,Romance
2002,85570368,38000000,5.1,47570368,Action
2002,85570368,38000000,5.1,47570368,Adventure
2002,85570368,38000000,5.1,47570368,Comedy
2002,85570368,38000000,5.1,47570368,Family
2002,85570368,38000000,5.1,47570368,Sci-Fi
2002,39177215,38000000,5.6,1177215,Crime
2002,39177215,38000000,5.6,1177215,Drama
2002,39177215,38000000,5.6,1177215,Thriller
2002,71026631,36000000,7,35026631,Crime
2002,71026631,36000000,7,35026631,Drama
2002,71026631,36000000,7,35026631,Thriller
2002,39532308,33000000,6.7,6532308,Action
2002,39532308,33000000,6.7,6532308,Horror
2002,39532308,33000000,6.7,6532308,Sci-Fi
2002,32519322,35000000,8.5,-2480678,Biography
2002,32519322,35000000,8.5,-2480678,Drama
2002,32519322,35000000,8.5,-2480678,War
2002,30307804,35000000,5.2,-4692196,Drama
2002,30307804,35000000,5.2,-4692196,Fantasy
2002,30307804,35000000,5.2,-4692196,Horror
2002,18306166,35000000,6.5,-16693834,Adventure
2002,18306166,35000000,6.5,-16693834,Drama
2002,18306166,35000000,6.5,-16693834,Romance
2002,18306166,35000000,6.5,-16693834,War
2002,6592103,35000000,6.3,-28407897,Crime
2002,6592103,35000000,6.3,-28407897,Drama
2002,6592103,35000000,6.3,-28407897,Mystery
2002,6592103,35000000,6.3,-28407897,Thriller
2002,81150692,35000000,5.1,46150692,Adventure
2002,81150692,35000000,5.1,46150692,Comedy
2002,81150692,35000000,5.1,46150692,Family
2002,81150692,35000000,5.1,46150692,Sport
2002,170684505,45000000,7.2,125684505,Comedy
2002,170684505,45000000,7.2,125684505,Crime
2002,170684505,45000000,7.2,125684505,Musical
2002,65010106,30000000,7.2,35010106,Comedy
2002,65010106,30000000,7.2,35010106,Drama
2002,51432423,30000000,5.1,21432423,Comedy
2002,51432423,30000000,5.1,21432423,Family
2002,51432423,30000000,5.1,21432423,Fantasy
2002,51432423,30000000,5.1,21432423,Sport
2002,40118420,30000000,5.6,10118420,Drama
2002,40118420,30000000,5.6,10118420,Romance
2002,40118420,30000000,5.6,10118420,Sport
2002,17266505,30000000,5.4,-12733495,Action
2002,17266505,30000000,5.4,-12733495,Comedy
2002,17266505,30000000,5.4,-12733495,Horror
2002,3517797,25000000,6.6,-21482203,Action
2002,3517797,25000000,6.6,-21482203,Crime
2002,3517797,25000000,6.6,-21482203,Drama
2002,3517797,25000000,6.6,-21482203,Romance
2002,3517797,25000000,6.6,-21482203,Thriller
2002,16930185,29000000,5.3,-12069815,Comedy
2002,16930185,29000000,5.3,-12069815,Romance
2002,69586544,27000000,6,42586544,Drama
2002,40566655,30000000,7.1,10566655,Comedy
2002,40566655,30000000,7.1,10566655,Drama
2002,40566655,30000000,7.1,10566655,Romance
2002,36985501,26000000,5.2,10985501,Action
2002,36985501,26000000,5.2,10985501,Adventure
2002,36985501,26000000,5.2,10985501,Comedy
2002,36985501,26000000,5.2,10985501,Sci-Fi
2002,36985501,26000000,5.2,10985501,Thriller
2002,39880476,25000000,5.2,14880476,Adventure
2002,39880476,25000000,5.2,14880476,Animation
2002,39880476,25000000,5.2,14880476,Comedy
2002,39880476,25000000,5.2,14880476,Family
2002,39880476,25000000,5.2,14880476,Fantasy
2002,38230435,25000000,5.8,13230435,Action
2002,38230435,25000000,5.8,13230435,Comedy
2002,41597830,25000000,7.6,16597830,Drama
2002,41597830,25000000,7.6,16597830,Romance
2002,17791031,25000000,7.3,-7208969,Comedy
2002,17791031,25000000,7.3,-7208969,Drama
2002,17791031,25000000,7.3,-7208969,Romance
2002,17791031,25000000,7.3,-7208969,Thriller
2002,15361537,13000000,4.6,2361537,Action
2002,15361537,13000000,4.6,2361537,Crime
2002,15361537,13000000,4.6,2361537,Thriller
2002,13973532,25000000,5.1,-11026468,Comedy
2002,13973532,25000000,5.1,-11026468,Crime
2002,10719367,25000000,4.9,-14280633,Drama
2002,10719367,25000000,4.9,-14280633,Music
2002,10719367,25000000,4.9,-14280633,Mystery
2002,10719367,25000000,4.9,-14280633,Romance
2002,10719367,25000000,4.9,-14280633,Thriller
2002,75597042,20000000,7,55597042,Drama
2002,75597042,20000000,7,55597042,Family
2002,75597042,20000000,7,55597042,Sport
2002,25296447,21000000,6.8,4296447,Action
2002,25296447,21000000,6.8,4296447,Crime
2002,25296447,21000000,6.8,4296447,Thriller
2002,6830957,21000000,6.7,-14169043,Drama
2002,6830957,21000000,6.7,-14169043,Romance
2002,56398162,20000000,5.7,36398162,Comedy
2002,56398162,20000000,5.7,36398162,Drama
2002,56398162,20000000,5.7,36398162,Music
2002,56398162,20000000,5.7,36398162,Romance
2002,48423368,20000000,5.8,28423368,Adventure
2002,48423368,20000000,5.8,28423368,Animation
2002,48423368,20000000,5.8,28423368,Family
2002,48423368,20000000,5.8,28423368,Fantasy
2002,30079316,35000000,5.5,-4920684,Horror
2002,16988996,35000000,4,-18011004,Comedy
2002,16988996,35000000,4,-18011004,Family
2002,16988996,35000000,4,-18011004,Music
2002,16988996,35000000,4,-18011004,Musical
2002,12987647,30000000,7.1,-17012353,Drama
2002,12987647,30000000,7.1,-17012353,Mystery
2002,12987647,30000000,7.1,-17012353,Romance
2002,12987647,30000000,7.1,-17012353,Thriller
2002,12987647,30000000,7.1,-17012353,War
2002,12398628,20000000,6.1,-7601372,Action
2002,12398628,20000000,6.1,-7601372,Crime
2002,12398628,20000000,6.1,-7601372,Drama
2002,12398628,20000000,6.1,-7601372,Sport
2002,1190018,20000000,7.5,-18809982,Action
2002,1190018,20000000,7.5,-18809982,Drama
2002,1190018,20000000,7.5,-18809982,Sci-Fi
2002,1190018,20000000,7.5,-18809982,Thriller
2002,121972,22000000,5.5,-21878028,Crime
2002,121972,22000000,5.5,-21878028,Drama
2002,121972,22000000,5.5,-21878028,Mystery
2002,22245861,19000000,7.7,3245861,Comedy
2002,22245861,19000000,7.7,3245861,Drama
2002,676698,18000000,7.2,-17323302,Crime
2002,676698,18000000,7.2,-17323302,Drama
2002,676698,18000000,7.2,-17323302,Mystery
2002,676698,18000000,7.2,-17323302,Thriller
2002,325491,17500000,6,-17174509,Crime
2002,325491,17500000,6,-17174509,Drama
2002,325491,17500000,6,-17174509,Thriller
2002,84961,31000000,7.9,-30915039,Action
2002,84961,31000000,7.9,-30915039,Adventure
2002,84961,31000000,7.9,-30915039,History
2002,37939782,17000000,5.6,20939782,Comedy
2002,37939782,17000000,5.6,20939782,Romance
2002,12693621,17000000,4.8,-4306379,Horror
2002,12693621,17000000,4.8,-4306379,Mystery
2002,12693621,17000000,4.8,-4306379,Thriller
2002,40363530,16000000,3.3,24363530,Comedy
2002,40363530,16000000,3.3,24363530,Family
2002,16346122,16000000,7.2,346122,Drama
2002,4839383,16000000,6.6,-11160617,Comedy
2002,4839383,16000000,6.6,-11160617,Romance
2002,13571817,15600000,4.5,-2028183,Comedy
2002,13571817,15600000,4.5,-2028183,Drama
2002,13571817,15600000,4.5,-2028183,Romance
2002,13571817,15600000,4.5,-2028183,Sport
2002,47811275,15000000,5.4,32811275,Adventure
2002,47811275,15000000,5.4,32811275,Comedy
2002,47811275,15000000,5.4,32811275,Family
2002,30259652,15000000,4.1,15259652,Comedy
2002,30259652,15000000,4.1,15259652,Horror
2002,30259652,15000000,4.1,15259652,Thriller
2002,19158074,15000000,6.7,4158074,Drama
2002,19158074,15000000,6.7,4158074,Family
2002,19158074,15000000,6.7,4158074,Fantasy
2002,19158074,15000000,6.7,4158074,Romance
2002,9059588,15000000,6.6,-5940412,Crime
2002,9059588,15000000,6.6,-5940412,Drama
2002,9059588,15000000,6.6,-5940412,Romance
2002,9059588,15000000,6.6,-5940412,Thriller
2002,8586376,20000000,4.9,-11413624,Comedy
2002,8378141,15000000,6.9,-6621859,Comedy
2002,8378141,15000000,6.9,-6621859,Drama
2002,8378141,15000000,6.9,-6621859,Romance
2002,25571351,14000000,6.6,11571351,Adventure
2002,25571351,14000000,6.6,11571351,Animation
2002,25571351,14000000,6.6,11571351,Comedy
2002,25571351,14000000,6.6,11571351,Drama
2002,25571351,14000000,6.6,11571351,Family
2002,25571351,14000000,6.6,11571351,Musical
2002,25482931,14000000,5.7,11482931,Action
2002,25482931,14000000,5.7,11482931,Comedy
2002,25482931,14000000,5.7,11482931,Crime
2002,25482931,14000000,5.7,11482931,Thriller
2002,47811275,15000000,5.4,32811275,Adventure
2002,47811275,15000000,5.4,32811275,Comedy
2002,47811275,15000000,5.4,32811275,Family
2002,274299,103000000,7.3,-102725701,Biography
2002,274299,103000000,7.3,-102725701,Crime
2002,274299,103000000,7.3,-102725701,Drama
2002,274299,103000000,7.3,-102725701,War
2002,15854988,13500000,7.4,2354988,Drama
2002,15854988,13500000,7.4,2354988,Romance
2002,28972187,13000000,5.9,15972187,Comedy
2002,28399192,13000000,5.4,15399192,Action
2002,28399192,13000000,5.4,15399192,Adventure
2002,28399192,13000000,5.4,15399192,Comedy
2002,28399192,13000000,5.4,15399192,Family
2002,21078145,12500000,7.3,8578145,Biography
2002,21078145,12500000,7.3,8578145,Drama
2002,14060950,12500000,6.9,1560950,Drama
2002,75074950,12000000,6.3,63074950,Comedy
2002,75074950,12000000,6.3,63074950,Drama
2002,37188667,12000000,3.3,25188667,Comedy
2002,37188667,12000000,3.3,25188667,Drama
2002,31597131,12000000,6.8,19597131,Drama
2002,31597131,12000000,6.8,19597131,Thriller
2002,25776062,12000000,7.4,13776062,Biography
2002,25776062,12000000,7.4,13776062,Drama
2002,25776062,12000000,7.4,13776062,Romance
2002,10198766,12000000,5.4,-1801234,Comedy
2002,1779284,12000000,7.1,-10220716,Comedy
2002,1779284,12000000,7.1,-10220716,Drama
2002,333976,12000000,6.4,-11666024,Comedy
2002,333976,12000000,6.4,-11666024,Crime
2002,46563158,13000000,7.1,33563158,Crime
2002,46563158,13000000,7.1,33563158,Thriller
2002,41227069,11000000,7.4,30227069,Drama
2002,41227069,11000000,7.4,30227069,Romance
2002,4814244,11000000,5.3,-6185756,Comedy
2002,4814244,11000000,5.3,-6185756,Romance
2002,3034181,11000000,5.4,-7965819,Comedy
2002,3034181,11000000,5.4,-7965819,Music
2002,3034181,11000000,5.4,-7965819,Romance
2002,22160085,10600000,5.4,11560085,Horror
2002,32983713,20000000,5.8,12983713,Comedy
2002,32983713,20000000,5.8,12983713,Drama
2002,30306281,10000000,5.6,20306281,Comedy
2002,30306281,10000000,5.6,20306281,Drama
2002,28563926,8500000,5,20063926,Drama
2002,28563926,8500000,5,20063926,Thriller
2002,16033556,10000000,6.2,6033556,Action
2002,16033556,10000000,6.2,6033556,Comedy
2002,13684949,3000000,5.9,10684949,Adventure
2002,13684949,3000000,5.9,10684949,Animation
2002,13684949,3000000,5.9,10684949,Comedy
2002,13684949,3000000,5.9,10684949,Family
2002,8111360,10000000,7.4,-1888640,Crime
2002,8111360,10000000,7.4,-1888640,Drama
2002,8111360,10000000,7.4,-1888640,Thriller
2002,6044618,10000000,5.6,-3955382,Action
2002,6044618,10000000,5.6,-3955382,Crime
2002,6044618,10000000,5.6,-3955382,Drama
2002,1641788,8000000,6.8,-6358212,Drama
2002,1641788,8000000,6.8,-6358212,Mystery
2002,1641788,8000000,6.8,-6358212,Thriller
2002,1309849,10000000,7.2,-8690151,Drama
2002,1309849,10000000,7.2,-8690151,Romance
2002,598645,10000000,3.6,-9401355,Comedy
2002,598645,10000000,3.6,-9401355,Romance
2002,4681503,9000000,7,-4318497,Comedy
2002,4681503,9000000,7,-4318497,Drama
2002,112935,9000000,7.6,-8887065,Drama
2002,45063889,8000000,7.6,37063889,Drama
2002,45063889,8000000,7.6,37063889,Horror
2002,45063889,8000000,7.6,37063889,Sci-Fi
2002,45063889,8000000,7.6,37063889,Thriller
2002,27362712,8000000,6.5,19362712,Comedy
2002,27362712,8000000,6.5,19362712,Drama
2002,27362712,8000000,6.5,19362712,Music
2002,27362712,8000000,6.5,19362712,Romance
2002,14015786,5000000,6.5,9015786,Drama
2002,14015786,5000000,6.5,9015786,Romance
2002,3076425,8000000,7.1,-4923575,Comedy
2002,3076425,8000000,7.1,-4923575,Crime
2002,3076425,8000000,7.1,-4923575,Musical
2002,3076425,8000000,7.1,-4923575,Romance
2002,10460089,7500000,7.2,2960089,Crime
2002,10460089,7500000,7.2,2960089,Drama
2002,10460089,7500000,7.2,2960089,Mystery
2002,10460089,7500000,7.2,2960089,Thriller
2002,4239767,7500000,6,-3260233,Comedy
2002,4239767,7500000,6,-3260233,Drama
2002,4239767,7500000,6,-3260233,Romance
2002,4239767,7500000,6,-3260233,Sport
2002,6165429,6000000,7.5,165429,Adventure
2002,6165429,6000000,7.5,165429,Biography
2002,6165429,6000000,7.5,165429,Drama
2002,6165429,6000000,7.5,165429,History
2002,2062066,7000000,6.6,-4937934,Biography
2002,2062066,7000000,6.6,-4937934,Crime
2002,2062066,7000000,6.6,-4937934,Drama
2002,236266,3500000,6.2,-3263734,Adventure
2002,236266,3500000,6.2,-3263734,Drama
2002,236266,3500000,6.2,-3263734,Mystery
2002,196067,7000000,6.7,-6803933,Drama
2002,196067,7000000,6.7,-6803933,Romance
2002,21005329,6000000,6.4,15005329,Comedy
2002,21005329,6000000,6.4,15005329,Romance
2002,3895664,5300000,7.3,-1404336,Comedy
2002,3895664,5300000,7.3,-1404336,Drama
2002,31874869,50000000,6.1,-18125131,Crime
2002,31874869,50000000,6.1,-18125131,Mystery
2002,31874869,50000000,6.1,-18125131,Thriller
2002,32541719,3500159,6.7,29041560,Comedy
2002,32541719,3500159,6.7,29041560,Drama
2002,32541719,3500159,6.7,29041560,Romance
2002,32541719,3500159,6.7,29041560,Sport
2002,3064356,5600000,6.9,-2535644,Drama
2002,3064356,5600000,6.9,-2535644,Romance
2002,64267897,5000000,6.6,59267897,Comedy
2002,64267897,5000000,6.6,59267897,Documentary
2002,241437427,5000000,6.6,236437427,Comedy
2002,241437427,5000000,6.6,236437427,Family
2002,241437427,5000000,6.6,236437427,Romance
2002,13060843,15000000,7.7,-1939157,Drama
2002,410241,2000000,6.8,-1589759,Comedy
2002,410241,2000000,6.8,-1589759,Crime
2002,410241,2000000,6.8,-1589759,Drama
2002,20772796,6000000,7.6,14772796,Drama
2002,20772796,6000000,7.6,14772796,Family
2002,6525762,4000000,6.7,2525762,Comedy
2002,6525762,4000000,6.7,2525762,Drama
2002,6525762,4000000,6.7,2525762,Romance
2002,4046737,4000000,7.1,46737,Comedy
2002,4046737,4000000,7.1,46737,Drama
2002,4046737,4000000,7.1,46737,Romance
2002,562059,4000000,7,-3437941,Drama
2002,562059,4000000,7,-3437941,Thriller
2002,146402,4000000,7.7,-3853598,Comedy
2002,146402,4000000,7.7,-3853598,Drama
2002,7563397,3300000,8.7,4263397,Crime
2002,7563397,3300000,8.7,4263397,Drama
2002,21244913,4000000,8,17244913,Crime
2002,21244913,4000000,8,17244913,Documentary
2002,21244913,4000000,8,17244913,Drama
2002,19184015,3000000,5.4,16184015,Biography
2002,19184015,3000000,5.4,16184015,Comedy
2002,19184015,3000000,5.4,16184015,Documentary
2002,5844929,3000000,7,2844929,Comedy
2002,5844929,3000000,7,2844929,Drama
2002,2506446,2000000,4.7,506446,Comedy
2002,2506446,2000000,4.7,506446,Romance
2002,13973532,25000000,5.1,-11026468,Comedy
2002,13973532,25000000,5.1,-11026468,Crime
2002,5709616,1800000,6.8,3909616,Drama
2002,5709616,1800000,6.8,3909616,Romance
2002,145540,500000,6.7,-354460,Drama
2002,145540,500000,6.7,-354460,Horror
2002,119841,1500000,6.5,-1380159,Drama
2002,39659,1600000,7,-1560341,Comedy
2002,39659,1600000,7,-1560341,Horror
2002,39659,1600000,7,-1560341,Musical
2002,464126,1000000,6.7,-535874,Drama
2002,15278,825000,5.6,-809722,Drama
2002,15278,825000,5.6,-809722,Fantasy
2002,15278,825000,5.6,-809722,Sci-Fi
2002,2073984,800000,7.2,1273984,Drama
2002,2073984,800000,7.2,1273984,Romance
2002,47329,750000,6.6,-702671,Drama
2002,1250798,500000,6.4,750798,Comedy
2002,1250798,500000,6.4,750798,Drama
2002,1250798,500000,6.4,750798,Romance
2002,243347,500000,5.3,-256653,Crime
2002,243347,500000,5.3,-256653,Drama
2002,243347,500000,5.3,-256653,Thriller
2002,13134,500000,6.1,-486866,Drama
2002,13134,500000,6.1,-486866,Sport
2002,37188667,12000000,3.3,25188667,Comedy
2002,37188667,12000000,3.3,25188667,Drama
2002,768045,2000000,7.7,-1231955,Drama
2002,768045,2000000,7.7,-1231955,History
2002,768045,2000000,7.7,-1231955,War
2002,3799339,250000,7.2,3549339,Crime
2002,3799339,250000,7.2,3549339,Drama
2002,3799339,250000,7.2,3549339,Romance
2002,174682,200000,6.9,-25318,Drama
2002,174682,200000,6.9,-25318,Music
2001,144512310,38000000,6.7,106512310,Action
2001,144512310,38000000,6.7,106512310,Crime
2001,144512310,38000000,6.7,106512310,Thriller
2001,198539855,140000000,6.1,58539855,Action
2001,198539855,140000000,6.1,58539855,Drama
2001,198539855,140000000,6.1,58539855,History
2001,198539855,140000000,6.1,58539855,Romance
2001,198539855,140000000,6.1,58539855,War
2001,32131830,137000000,6.4,-104868170,Action
2001,32131830,137000000,6.4,-104868170,Adventure
2001,32131830,137000000,6.4,-104868170,Animation
2001,32131830,137000000,6.4,-104868170,Fantasy
2001,32131830,137000000,6.4,-104868170,Romance
2001,32131830,137000000,6.4,-104868170,Sci-Fi
2001,317557891,125000000,7.5,192557891,Adventure
2001,317557891,125000000,7.5,192557891,Family
2001,317557891,125000000,7.5,192557891,Fantasy
2001,289907418,115000000,8.1,174907418,Adventure
2001,289907418,115000000,8.1,174907418,Animation
2001,289907418,115000000,8.1,174907418,Comedy
2001,289907418,115000000,8.1,174907418,Family
2001,289907418,115000000,8.1,174907418,Fantasy
2001,313837577,93000000,8.8,220837577,Action
2001,313837577,93000000,8.8,220837577,Adventure
2001,313837577,93000000,8.8,220837577,Drama
2001,313837577,93000000,8.8,220837577,Fantasy
2001,58183966,107000000,6.8,-48816034,Biography
2001,58183966,107000000,6.8,-48816034,Drama
2001,58183966,107000000,6.8,-48816034,Sport
2001,6712451,90000000,4.4,-83287549,Comedy
2001,6712451,90000000,4.4,-83287549,Romance
2001,180011740,100000000,5.7,80011740,Action
2001,180011740,100000000,5.7,80011740,Adventure
2001,180011740,100000000,5.7,80011740,Sci-Fi
2001,180011740,100000000,5.7,80011740,Thriller
2001,202007640,98000000,6.3,104007640,Action
2001,202007640,98000000,6.3,104007640,Adventure
2001,202007640,98000000,6.3,104007640,Fantasy
2001,202007640,98000000,6.3,104007640,Thriller
2001,108638745,92000000,7.7,16638745,Drama
2001,108638745,92000000,7.7,16638745,History
2001,108638745,92000000,7.7,16638745,War
2001,131144183,115000000,5.7,16144183,Action
2001,131144183,115000000,5.7,16144183,Adventure
2001,131144183,115000000,5.7,16144183,Fantasy
2001,131144183,115000000,5.7,16144183,Thriller
2001,181166115,93000000,5.9,88166115,Action
2001,181166115,93000000,5.9,88166115,Adventure
2001,181166115,93000000,5.9,88166115,Sci-Fi
2001,181166115,93000000,5.9,88166115,Thriller
2001,226138454,90000000,6.6,136138454,Action
2001,226138454,90000000,6.6,136138454,Comedy
2001,226138454,90000000,6.6,136138454,Crime
2001,226138454,90000000,6.6,136138454,Thriller
2001,84037039,120000000,6.8,-35962961,Action
2001,84037039,120000000,6.8,-35962961,Adventure
2001,84037039,120000000,6.8,-35962961,Animation
2001,84037039,120000000,6.8,-35962961,Family
2001,84037039,120000000,6.8,-35962961,Fantasy
2001,84037039,120000000,6.8,-35962961,Sci-Fi
2001,78616689,100000000,7.1,-21383311,Adventure
2001,78616689,100000000,7.1,-21383311,Drama
2001,78616689,100000000,7.1,-21383311,Sci-Fi
2001,26871,92000000,7,-91973129,Action
2001,26871,92000000,7,-91973129,Crime
2001,26871,92000000,7,-91973129,Thriller
2001,144512310,38000000,6.7,106512310,Action
2001,144512310,38000000,6.7,106512310,Crime
2001,144512310,38000000,6.7,106512310,Thriller
2001,183405771,85000000,7.8,98405771,Crime
2001,183405771,85000000,7.8,98405771,Thriller
2001,51396781,68000000,7.6,-16603219,Drama
2001,51396781,68000000,7.6,-16603219,History
2001,51396781,68000000,7.6,-16603219,War
2001,69772969,80000000,6.5,-10227031,Action
2001,69772969,80000000,6.5,-10227031,Crime
2001,69772969,80000000,6.5,-10227031,Thriller
2001,170708996,58000000,8.2,112708996,Biography
2001,170708996,58000000,8.2,112708996,Drama
2001,41523271,80000000,6.6,-38476729,Comedy
2001,41523271,80000000,6.6,-38476729,Crime
2001,41523271,80000000,6.6,-38476729,Drama
2001,41523271,80000000,6.6,-38476729,Romance
2001,5409517,75000000,4.7,-69590483,Animation
2001,5409517,75000000,4.7,-69590483,Comedy
2001,5409517,75000000,4.7,-69590483,Fantasy
2001,112950721,72000000,4.6,40950721,Comedy
2001,112950721,72000000,4.6,40950721,Family
2001,112950721,72000000,4.6,40950721,Fantasy
2001,27796042,72000000,6.9,-44203958,Drama
2001,27796042,72000000,6.9,-44203958,Romance
2001,32616869,72000000,4.5,-39383131,Action
2001,32616869,72000000,4.5,-39383131,Drama
2001,32616869,72000000,4.5,-39383131,Sport
2001,100614858,68000000,6.9,32614858,Fantasy
2001,100614858,68000000,6.9,32614858,Mystery
2001,100614858,68000000,6.9,32614858,Romance
2001,100614858,68000000,6.9,32614858,Sci-Fi
2001,100614858,68000000,6.9,32614858,Thriller
2001,13596911,70000000,6.2,-56403089,Action
2001,13596911,70000000,6.2,-56403089,Adventure
2001,13596911,70000000,6.2,-56403089,Animation
2001,13596911,70000000,6.2,-56403089,Comedy
2001,13596911,70000000,6.2,-56403089,Crime
2001,13596911,70000000,6.2,-56403089,Family
2001,13596911,70000000,6.2,-56403089,Fantasy
2001,71069884,68000000,6.8,3069884,Crime
2001,71069884,68000000,6.8,3069884,Drama
2001,71069884,68000000,6.8,3069884,Thriller
2001,15738632,42000000,5.9,-26261368,Action
2001,15738632,42000000,5.9,-26261368,Comedy
2001,15738632,42000000,5.9,-26261368,Crime
2001,15738632,42000000,5.9,-26261368,Thriller
2001,93375151,60000000,5.2,33375151,Action
2001,93375151,60000000,5.2,33375151,Comedy
2001,93375151,60000000,5.2,33375151,Family
2001,93375151,60000000,5.2,33375151,Fantasy
2001,18208078,60000000,6.9,-41791922,Action
2001,18208078,60000000,6.9,-41791922,Drama
2001,18208078,60000000,6.9,-41791922,Thriller
2001,25528495,57000000,5.9,-31471505,Drama
2001,25528495,57000000,5.9,-31471505,Music
2001,25528495,57000000,5.9,-31471505,Romance
2001,25528495,57000000,5.9,-31471505,War
2001,57386369,52500000,7.6,4886369,Drama
2001,57386369,52500000,7.6,4886369,Musical
2001,57386369,52500000,7.6,4886369,Romance
2001,45207112,53000000,5.5,-7792888,Crime
2001,45207112,53000000,5.5,-7792888,Mystery
2001,45207112,53000000,5.5,-7792888,Thriller
2001,267652016,60000000,7.9,207652016,Adventure
2001,267652016,60000000,7.9,207652016,Animation
2001,267652016,60000000,7.9,207652016,Comedy
2001,267652016,60000000,7.9,207652016,Family
2001,267652016,60000000,7.9,207652016,Fantasy
2001,54997476,50000000,6.3,4997476,Crime
2001,54997476,50000000,6.3,4997476,Drama
2001,54997476,50000000,6.3,4997476,Mystery
2001,54997476,50000000,6.3,4997476,Thriller
2001,43905746,49000000,5.9,-5094254,Action
2001,43905746,49000000,5.9,-5094254,Sci-Fi
2001,43905746,49000000,5.9,-5094254,Thriller
2001,56607223,48000000,6.4,8607223,Adventure
2001,56607223,48000000,6.4,8607223,Comedy
2001,50173190,48000000,7.4,2173190,Drama
2001,50173190,48000000,7.4,2173190,Mystery
2001,50173190,48000000,7.4,2173190,Sci-Fi
2001,47095453,48000000,6.4,-904547,Comedy
2001,47095453,48000000,6.4,-904547,Fantasy
2001,47095453,48000000,6.4,-904547,Romance
2001,29781453,48000000,6.4,-18218547,Biography
2001,29781453,48000000,6.4,-18218547,Comedy
2001,29781453,48000000,6.4,-18218547,Drama
2001,93607673,48000000,5.7,45607673,Comedy
2001,93607673,48000000,5.7,45607673,Romance
2001,76261036,45000000,7.7,31261036,Crime
2001,76261036,45000000,7.7,31261036,Drama
2001,76261036,45000000,7.7,31261036,Thriller
2001,71277420,45000000,5.2,26277420,Comedy
2001,31598308,35000000,6.8,-3401692,Horror
2001,31598308,35000000,6.8,-3401692,Mystery
2001,31598308,35000000,6.8,-3401692,Thriller
2001,19719930,45000000,6.8,-25280070,Crime
2001,19719930,45000000,6.8,-25280070,Drama
2001,19719930,45000000,6.8,-25280070,Mystery
2001,19719930,45000000,6.8,-25280070,Thriller
2001,24375436,42000000,6.1,-17624564,Action
2001,24375436,42000000,6.1,-17624564,Crime
2001,24375436,42000000,6.1,-17624564,Drama
2001,24375436,42000000,6.1,-17624564,Thriller
2001,56083966,65000000,6.9,-8916034,Action
2001,56083966,65000000,6.9,-8916034,Adventure
2001,56083966,65000000,6.9,-8916034,Romance
2001,70836296,40000000,5.9,30836296,Comedy
2001,70836296,40000000,5.9,30836296,Drama
2001,70836296,40000000,5.9,30836296,Fantasy
2001,70836296,40000000,5.9,30836296,Romance
2001,66808615,34000000,6.1,32808615,Adventure
2001,66808615,34000000,6.1,32808615,Comedy
2001,66808615,34000000,6.1,32808615,Crime
2001,66808615,34000000,6.1,32808615,Romance
2001,59068786,40000000,6.4,19068786,Action
2001,59068786,40000000,6.4,19068786,Drama
2001,59068786,40000000,6.4,19068786,Thriller
2001,59068786,40000000,6.4,19068786,War
2001,27053815,40000000,4.7,-12946185,Action
2001,27053815,40000000,4.7,-12946185,Adventure
2001,27053815,40000000,4.7,-12946185,Romance
2001,25178165,40000000,6.7,-14821835,Drama
2001,25178165,40000000,6.7,-14821835,Romance
2001,33201661,77000000,8.4,-43798339,Comedy
2001,33201661,77000000,8.4,-43798339,Romance
2001,6114237,40000000,6.2,-33885763,Drama
2001,6114237,40000000,6.2,-33885763,Mystery
2001,6114237,40000000,6.2,-33885763,Sci-Fi
2001,6114237,40000000,6.2,-33885763,Thriller
2001,4777007,40000000,5.8,-35222993,Comedy
2001,4777007,40000000,5.8,-35222993,Fantasy
2001,4777007,40000000,5.8,-35222993,Sci-Fi
2001,144512310,38000000,6.7,106512310,Action
2001,144512310,38000000,6.7,106512310,Crime
2001,144512310,38000000,6.7,106512310,Thriller
2001,40334024,35000000,6.2,5334024,Comedy
2001,40334024,35000000,6.2,5334024,Crime
2001,40334024,35000000,6.2,5334024,Romance
2001,24044532,38000000,5.6,-13955468,Drama
2001,24044532,38000000,5.6,-13955468,Romance
2001,22770864,38000000,5.5,-15229136,Comedy
2001,22770864,38000000,5.5,-15229136,Drama
2001,16991902,57000000,6.2,-40008098,Drama
2001,16991902,57000000,6.2,-40008098,Music
2001,623374,38000000,5.2,-37376626,Action
2001,623374,38000000,5.2,-37376626,Adventure
2001,623374,38000000,5.2,-37376626,Drama
2001,623374,38000000,5.2,-37376626,Thriller
2001,623374,38000000,5.2,-37376626,Western
2001,112692062,35000000,5.4,77692062,Action
2001,112692062,35000000,5.4,77692062,Adventure
2001,112692062,35000000,5.4,77692062,Comedy
2001,112692062,35000000,5.4,77692062,Family
2001,112692062,35000000,5.4,77692062,Sci-Fi
2001,33422806,50000000,4.8,-16577194,Adventure
2001,33422806,50000000,4.8,-16577194,Comedy
2001,33422806,50000000,4.8,-16577194,Fantasy
2001,31598308,35000000,6.8,-3401692,Horror
2001,31598308,35000000,6.8,-3401692,Mystery
2001,31598308,35000000,6.8,-3401692,Thriller
2001,11405825,35000000,6.8,-23594175,Drama
2001,13264986,35000000,6,-21735014,Action
2001,13264986,35000000,6,-21735014,Western
2001,51758599,33000000,5.5,18758599,Action
2001,51758599,33000000,5.5,18758599,Comedy
2001,51758599,33000000,5.5,18758599,Crime
2001,51758599,33000000,5.5,18758599,Drama
2001,51758599,33000000,5.5,18758599,Thriller
2001,24185781,31000000,6.9,-6814219,Drama
2001,24185781,31000000,6.9,-6814219,Mystery
2001,145096820,30000000,6.4,115096820,Comedy
2001,108244774,37000000,6.2,71244774,Comedy
2001,108244774,37000000,6.2,71244774,Family
2001,108244774,37000000,6.2,71244774,Romance
2001,64172251,30000000,5.4,34172251,Comedy
2001,64172251,30000000,5.4,34172251,Fantasy
2001,52937130,30000000,7.6,22937130,Biography
2001,52937130,30000000,7.6,22937130,Crime
2001,52937130,30000000,7.6,22937130,Drama
2001,32095318,45000000,5.5,-12904682,Comedy
2001,32095318,45000000,5.5,-12904682,Crime
2001,10965209,30000000,6.1,-19034791,Action
2001,10965209,30000000,6.1,-19034791,Crime
2001,10965209,30000000,6.1,-19034791,Drama
2001,10965209,30000000,6.1,-19034791,Thriller
2001,74058698,60000000,6.3,14058698,Crime
2001,74058698,60000000,6.3,14058698,Drama
2001,74058698,60000000,6.3,14058698,Thriller
2001,60400856,35000000,5.2,25400856,Comedy
2001,60400856,35000000,5.2,25400856,Romance
2001,52353636,21000000,7.6,31353636,Comedy
2001,52353636,21000000,7.6,31353636,Drama
2001,49968653,28000000,6.9,21968653,Comedy
2001,49968653,28000000,6.9,21968653,Romance
2001,45162741,28000000,6.6,17162741,Comedy
2001,10762178,160000000,8,-149237822,Documentary
2001,8434601,28000000,4.9,-19565399,Action
2001,8434601,28000000,4.9,-19565399,Horror
2001,8434601,28000000,4.9,-19565399,Sci-Fi
2001,5204007,28000000,6.3,-22795993,Action
2001,5204007,28000000,6.3,-22795993,Comedy
2001,5204007,28000000,6.3,-22795993,Crime
2001,5204007,28000000,6.3,-22795993,Thriller
2001,16252765,42000000,6,-25747235,Drama
2001,16252765,42000000,6,-25747235,Mystery
2001,16252765,42000000,6,-25747235,Romance
2001,16252765,42000000,6,-25747235,Thriller
2001,7496522,26000000,6.8,-18503478,Comedy
2001,7496522,26000000,6.8,-18503478,Crime
2001,7496522,26000000,6.8,-18503478,Mystery
2001,7496522,26000000,6.8,-18503478,Romance
2001,80920948,30000000,6,50920948,Action
2001,80920948,30000000,6,50920948,Adventure
2001,80920948,30000000,6,50920948,Animation
2001,80920948,30000000,6,50920948,Comedy
2001,80920948,30000000,6,50920948,Family
2001,80920948,30000000,6,50920948,Sci-Fi
2001,71500556,26000000,6.7,45500556,Comedy
2001,71500556,26000000,6.7,45500556,Drama
2001,71500556,26000000,6.7,45500556,Romance
2001,36833473,25000000,6.6,11833473,Action
2001,36833473,25000000,6.6,11833473,Crime
2001,36833473,25000000,6.6,11833473,Drama
2001,36833473,25000000,6.6,11833473,Thriller
2001,25590119,21150000,4.8,4440119,Adventure
2001,25590119,21150000,4.8,4440119,Comedy
2001,25590119,21150000,4.8,4440119,Crime
2001,5516708,25000000,4.9,-19483292,Comedy
2001,5516708,25000000,4.9,-19483292,Romance
2001,20218,24000000,5.3,-23979782,Action
2001,20218,24000000,5.3,-23979782,Comedy
2001,20218,24000000,5.3,-23979782,Crime
2001,20218,24000000,5.3,-23979782,Thriller
2001,27338033,23000000,6.1,4338033,Comedy
2001,27338033,23000000,6.1,4338033,Romance
2001,21973182,23000000,6.6,-1026818,Mystery
2001,21973182,23000000,6.6,-1026818,Thriller
2001,55762229,22000000,4.8,33762229,Comedy
2001,55762229,22000000,4.8,33762229,Sci-Fi
2001,40270895,22000000,7.6,18270895,Drama
2001,19351569,22000000,5.9,-2648431,Comedy
2001,19351569,22000000,5.9,-2648431,Crime
2001,19351569,22000000,5.9,-2648431,Romance
2001,30059386,22000000,6.9,8059386,Comedy
2001,17951431,30000000,5.8,-12048569,Crime
2001,17951431,30000000,5.8,-12048569,Drama
2001,17951431,30000000,5.8,-12048569,Mystery
2001,17951431,30000000,5.8,-12048569,Thriller
2001,14252830,22000000,5.3,-7747170,Comedy
2001,14252830,22000000,5.3,-7747170,Music
2001,5974653,22000000,4.1,-16025347,Action
2001,5974653,22000000,4.1,-16025347,Adventure
2001,5974653,22000000,4.1,-16025347,Fantasy
2001,5974653,22000000,4.1,-16025347,Sci-Fi
2001,5974653,22000000,4.1,-16025347,Thriller
2001,40219708,21000000,6.3,19219708,Drama
2001,40219708,21000000,6.3,19219708,Sport
2001,41867960,20000000,5.5,21867960,Horror
2001,10049886,19000000,8.6,-8950114,Adventure
2001,10049886,19000000,8.6,-8950114,Animation
2001,10049886,19000000,8.6,-8950114,Family
2001,10049886,19000000,8.6,-8950114,Fantasy
2001,95001351,18000000,6.2,77001351,Comedy
2001,95001351,18000000,6.2,77001351,Romance
2001,41300105,19800000,7.3,21500105,Drama
2001,41300105,19800000,7.3,21500105,Mystery
2001,15561627,18000000,7.5,-2438373,Drama
2001,13491653,18000000,6.1,-4508347,Drama
2001,13491653,18000000,6.1,-4508347,Thriller
2001,96471845,17000000,7.6,79471845,Fantasy
2001,96471845,17000000,7.6,79471845,Horror
2001,96471845,17000000,7.6,79471845,Thriller
2001,19693891,34000000,4.9,-14306109,Comedy
2001,19693891,34000000,4.9,-14306109,Drama
2001,19693891,34000000,4.9,-14306109,Romance
2001,19693891,34000000,4.9,-14306109,Sport
2001,33357476,35000000,5.4,-1642524,Action
2001,33357476,35000000,5.4,-1642524,Comedy
2001,33357476,35000000,5.4,-1642524,Crime
2001,33357476,35000000,5.4,-1642524,Family
2001,28734552,16000000,6.4,12734552,Crime
2001,28734552,16000000,6.4,12734552,Drama
2001,28734552,16000000,6.4,12734552,Romance
2001,28734552,16000000,6.4,12734552,Thriller
2001,27087695,17700000,5.9,9387695,Adventure
2001,27087695,17700000,5.9,9387695,Comedy
2001,27087695,17700000,5.9,9387695,Drama
2001,81525,15300000,6.6,-15218475,Action
2001,81525,15300000,6.6,-15218475,Comedy
2001,81525,15300000,6.6,-15218475,Crime
2001,81525,15300000,6.6,-15218475,Drama
2001,81525,15300000,6.6,-15218475,Thriller
2001,37882551,16000000,5.7,21882551,Comedy
2001,14249005,15000000,4.5,-750995,Comedy
2001,7219578,15000000,8,-7780422,Drama
2001,7219578,15000000,8,-7780422,Mystery
2001,7219578,15000000,8,-7780422,Thriller
2001,353743,15000000,6.9,-14646257,Comedy
2001,353743,15000000,6.9,-14646257,Crime
2001,353743,15000000,6.9,-14646257,Drama
2001,353743,15000000,6.9,-14646257,Thriller
2001,353743,15000000,6.9,-14646257,War
2001,22723,25000000,4.5,-24977277,Action
2001,22723,25000000,4.5,-24977277,Comedy
2001,22723,25000000,4.5,-24977277,Drama
2001,22723,25000000,4.5,-24977277,War
2001,12610731,11000000,4.4,1610731,Action
2001,12610731,11000000,4.4,1610731,Horror
2001,12610731,11000000,4.4,1610731,Sci-Fi
2001,12610731,11000000,4.4,1610731,Thriller
2001,10397365,14000000,5.4,-3602635,Comedy
2001,10397365,14000000,5.4,-3602635,Mystery
2001,10397365,14000000,5.4,-3602635,Romance
2001,3100650,14000000,3.9,-10899350,Drama
2001,3100650,14000000,3.9,-10899350,Horror
2001,3100650,14000000,3.9,-10899350,Mystery
2001,3100650,14000000,3.9,-10899350,Thriller
2001,91038276,13000000,6.1,78038276,Drama
2001,91038276,13000000,6.1,78038276,Music
2001,91038276,13000000,6.1,78038276,Romance
2001,22235901,6000000,6.1,16235901,Comedy
2001,22235901,6000000,6.1,16235901,Romance
2001,16929123,14000000,6.5,2929123,Drama
2001,16929123,14000000,6.5,2929123,Romance
2001,5002310,13000000,5.6,-7997690,Adventure
2001,5002310,13000000,5.6,-7997690,Comedy
2001,5002310,13000000,5.6,-7997690,Romance
2001,5002310,13000000,5.6,-7997690,Sci-Fi
2001,4919896,13000000,6.1,-8080104,Comedy
2001,4919896,13000000,6.1,-8080104,Crime
2001,4919896,13000000,6.1,-8080104,Thriller
2001,31155435,12000000,6.2,19155435,Comedy
2001,31155435,12000000,6.2,19155435,Fantasy
2001,17292381,12000000,5.3,5292381,Comedy
2001,17292381,12000000,5.3,5292381,Crime
2001,17292381,12000000,5.3,5292381,Family
2001,2326407,12000000,7,-9673593,Drama
2001,23978402,11000000,4.6,12978402,Comedy
2001,23978402,11000000,4.6,12978402,Crime
2001,13903262,11000000,6.3,2903262,Comedy
2001,13903262,11000000,6.3,2903262,Sport
2001,13558739,11000000,5.3,2558739,Comedy
2001,13103828,11000000,7.3,2103828,Crime
2001,13103828,11000000,7.3,2103828,Drama
2001,13103828,11000000,7.3,2103828,Thriller
2001,16017403,5000000,6.2,11017403,Drama
2001,16017403,5000000,6.2,11017403,Romance
2001,16017403,5000000,6.2,11017403,Thriller
2001,37470017,10000000,6.1,27470017,Horror
2001,37470017,10000000,6.1,27470017,Mystery
2001,36696761,23000000,6.5,13696761,Animation
2001,36696761,23000000,6.5,13696761,Comedy
2001,36696761,23000000,6.5,13696761,Family
2001,36696761,23000000,6.5,13696761,Mystery
2001,36696761,23000000,6.5,13696761,Sci-Fi
2001,20384136,10000000,4.7,10384136,Horror
2001,20384136,10000000,4.7,10384136,Mystery
2001,20384136,10000000,4.7,10384136,Thriller
2001,11560259,22000000,5.8,-10439741,Comedy
2001,11560259,22000000,5.8,-10439741,Romance
2001,4356743,16000000,4.1,-11643257,Comedy
2001,4356743,16000000,4.1,-11643257,Family
2001,4356743,16000000,4.1,-11643257,Romance
2001,488872,10000000,7.3,-9511128,Action
2001,488872,10000000,7.3,-9511128,Comedy
2001,488872,10000000,7.3,-9511128,Sport
2001,226792,10000000,6.2,-9773208,Action
2001,226792,10000000,6.2,-9773208,Comedy
2001,226792,10000000,6.2,-9773208,Drama
2001,454255,400000000,6.6,-399545745,Action
2001,454255,400000000,6.6,-399545745,Adventure
2001,454255,400000000,6.6,-399545745,Drama
2001,454255,400000000,6.6,-399545745,History
2001,454255,400000000,6.6,-399545745,War
2001,4273372,22000000,2.1,-17726628,Drama
2001,4273372,22000000,2.1,-17726628,Music
2001,4273372,22000000,2.1,-17726628,Romance
2001,206400,50000000,6.9,-49793600,Comedy
2001,206400,50000000,6.9,-49793600,Crime
2001,206400,50000000,6.9,-49793600,Drama
2001,206400,50000000,6.9,-49793600,Romance
2001,206400,50000000,6.9,-49793600,Thriller
2001,4720371,7000000,6.5,-2279629,Adventure
2001,4720371,7000000,6.5,-2279629,Biography
2001,4720371,7000000,6.5,-2279629,Drama
2001,6173485,7000000,7.7,-826515,Biography
2001,6173485,7000000,7.7,-826515,Drama
2001,27457409,6000000,6.3,21457409,Comedy
2001,27457409,6000000,6.3,21457409,Drama
2001,3029081,6000000,7.8,-2970919,Comedy
2001,3029081,6000000,7.8,-2970919,Drama
2001,3029081,6000000,7.8,-2970919,Music
2001,3029081,6000000,7.8,-2970919,Musical
2001,2025238,6000000,5.8,-3974762,Comedy
2001,2025238,6000000,5.8,-3974762,Crime
2001,2025238,6000000,5.8,-3974762,Drama
2001,2025238,6000000,5.8,-3974762,Thriller
2001,54606,6000000,6.2,-5945394,Comedy
2001,54606,6000000,6.2,-5945394,Crime
2001,54606,6000000,6.2,-5945394,Romance
2001,6200756,7000000,7.4,-799244,Comedy
2001,6200756,7000000,7.4,-799244,Drama
2001,1292119,5500000,7.1,-4207881,Biography
2001,1292119,5500000,7.1,-4207881,Drama
2001,1292119,5500000,7.1,-4207881,Romance
2001,56007,5500000,4.9,-5443993,Comedy
2001,56007,5500000,4.9,-5443993,Crime
2001,56007,5500000,4.9,-5443993,Drama
2001,56007,5500000,4.9,-5443993,Romance
2001,56007,5500000,4.9,-5443993,Thriller
2001,16017403,5000000,6.2,11017403,Drama
2001,16017403,5000000,6.2,11017403,Romance
2001,16017403,5000000,6.2,11017403,Thriller
2001,13622333,2000000,7.7,11622333,Adventure
2001,13622333,2000000,7.7,11622333,Comedy
2001,13622333,2000000,7.7,11622333,Drama
2001,13622333,2000000,7.7,11622333,Romance
2001,6755271,5000000,5.3,1755271,Horror
2001,6755271,5000000,5.3,1755271,Thriller
2001,5308707,5000000,6.4,308707,Comedy
2001,5308707,5000000,6.4,308707,Crime
2001,5308707,5000000,6.4,308707,Drama
2001,5308707,5000000,6.4,308707,Thriller
2001,727883,4500000,8.1,-3772117,Drama
2001,727883,4500000,8.1,-3772117,Sci-Fi
2001,727883,4500000,8.1,-3772117,Thriller
2001,92191,2500000,6.5,-2407809,Comedy
2001,92191,2500000,6.5,-2407809,Drama
2001,92191,2500000,6.5,-2407809,Sport
2001,31252964,4000000,7.1,27252964,Drama
2001,31252964,4000000,7.1,27252964,Romance
2001,180011740,100000000,5.7,80011740,Action
2001,180011740,100000000,5.7,80011740,Adventure
2001,180011740,100000000,5.7,80011740,Sci-Fi
2001,180011740,100000000,5.7,80011740,Thriller
2001,10097096,4000000,4.6,6097096,Comedy
2001,3293258,3000000,5.2,293258,Action
2001,3293258,3000000,5.2,293258,Adventure
2001,3293258,3000000,5.2,293258,Comedy
2001,3293258,3000000,5.2,293258,Musical
2001,3287435,4500000,7.1,-1212565,Drama
2001,313436,15500000,7.6,-15186564,Comedy
2001,313436,15500000,7.6,-15186564,Drama
2001,35918429,1700000,7.5,34218429,Crime
2001,35918429,1700000,7.5,34218429,Drama
2001,7022940,1000000,6.7,6022940,Comedy
2001,7022940,1000000,6.7,6022940,Drama
2001,7022940,1000000,6.7,6022940,Romance
2001,406035,1500000,7.2,-1093965,Drama
2001,373967,1500000,6.5,-1126033,Horror
2001,373967,1500000,6.5,-1126033,Mystery
2001,18488314,1200000,7.1,17288314,Comedy
2001,18488314,1200000,7.1,17288314,Crime
2001,18488314,1200000,7.1,17288314,Mystery
2001,13876974,7000000,7.4,6876974,Comedy
2001,13876974,7000000,7.4,6876974,Drama
2001,13876974,7000000,7.4,6876974,Romance
2001,58936,1200000,6.1,-1141064,Comedy
2001,58936,1200000,6.1,-1141064,Music
2001,798341,1000000,7.2,-201659,Crime
2001,798341,1000000,7.2,-201659,Drama
2001,798341,1000000,7.2,-201659,Mystery
2001,703,1500000,5.4,-1499297,Comedy
2001,703,1500000,5.4,-1499297,Drama
2001,1141829,700000,7.2,441829,Crime
2001,1141829,700000,7.2,441829,Drama
2001,295468,500000,6,-204532,Comedy
2001,295468,500000,6,-204532,Romance
2001,16892,300000,7.6,-283108,Documentary
2001,4186931,250000,6.9,3936931,Comedy
2001,4186931,250000,6.9,3936931,Drama
2001,4186931,250000,6.9,3936931,Romance
2001,902835,250000,6.7,652835,Comedy
2001,902835,250000,6.7,652835,Drama
2001,902835,250000,6.7,652835,Romance
2001,110536,40000,7,70536,Comedy
2001,110536,40000,7,70536,Horror
2001,110536,40000,7,70536,Sci-Fi
2000,137748063,127500000,6.5,10248063,Adventure
2000,137748063,127500000,6.5,10248063,Animation
2000,137748063,127500000,6.5,10248063,Family
2000,137748063,127500000,6.5,10248063,Thriller
2000,260031035,123000000,6,137031035,Comedy
2000,260031035,123000000,6,137031035,Family
2000,260031035,123000000,6,137031035,Fantasy
2000,215397307,125000000,6.1,90397307,Action
2000,215397307,125000000,6.1,90397307,Adventure
2000,215397307,125000000,6.1,90397307,Thriller
2000,182618434,140000000,6.4,42618434,Action
2000,182618434,140000000,6.4,42618434,Adventure
2000,182618434,140000000,6.4,42618434,Drama
2000,182618434,140000000,6.4,42618434,Thriller
2000,113330342,110000000,7.1,3330342,Action
2000,113330342,110000000,7.1,3330342,Drama
2000,113330342,110000000,7.1,3330342,History
2000,113330342,110000000,7.1,3330342,War
2000,101643008,90000000,6.5,11643008,Action
2000,101643008,90000000,6.5,11643008,Crime
2000,101643008,90000000,6.5,11643008,Thriller
2000,187670866,103000000,8.5,84670866,Action
2000,187670866,103000000,8.5,84670866,Drama
2000,187670866,103000000,8.5,84670866,Romance
2000,89296573,100000000,7.3,-10703427,Adventure
2000,89296573,100000000,7.3,-10703427,Animation
2000,89296573,100000000,7.3,-10703427,Comedy
2000,89296573,100000000,7.3,-10703427,Family
2000,89296573,100000000,7.3,-10703427,Fantasy
2000,50802661,95000000,6.9,-44197339,Adventure
2000,50802661,95000000,6.9,-44197339,Animation
2000,50802661,95000000,6.9,-44197339,Comedy
2000,50802661,95000000,6.9,-44197339,Family
2000,50802661,95000000,6.9,-44197339,Romance
2000,155370362,100000000,6.6,55370362,Drama
2000,155370362,100000000,6.6,55370362,Fantasy
2000,155370362,100000000,6.6,55370362,Horror
2000,155370362,100000000,6.6,55370362,Mystery
2000,155370362,100000000,6.6,55370362,Thriller
2000,125305545,92000000,5.5,33305545,Action
2000,125305545,92000000,5.5,33305545,Adventure
2000,125305545,92000000,5.5,33305545,Comedy
2000,125305545,92000000,5.5,33305545,Crime
2000,125305545,92000000,5.5,33305545,Thriller
2000,73209340,95000000,5.7,-21790660,Action
2000,73209340,95000000,5.7,-21790660,Horror
2000,73209340,95000000,5.7,-21790660,Sci-Fi
2000,73209340,95000000,5.7,-21790660,Thriller
2000,60874615,90000000,5.6,-29125385,Adventure
2000,60874615,90000000,5.6,-29125385,Sci-Fi
2000,60874615,90000000,5.6,-29125385,Thriller
2000,233630478,90000000,7.7,143630478,Adventure
2000,233630478,90000000,7.7,143630478,Drama
2000,233630478,90000000,7.7,143630478,Romance
2000,66941559,85000000,4.8,-18058441,Adventure
2000,66941559,85000000,4.8,-18058441,Comedy
2000,66941559,85000000,4.8,-18058441,Family
2000,123307945,65000000,4.3,58307945,Comedy
2000,123307945,65000000,4.3,58307945,Romance
2000,123307945,65000000,4.3,58307945,Sci-Fi
2000,34543701,82000000,5.9,-47456299,Action
2000,34543701,82000000,5.9,-47456299,Mystery
2000,34543701,82000000,5.9,-47456299,Sci-Fi
2000,34543701,82000000,5.9,-47456299,Thriller
2000,39442871,80000000,5.3,-40557129,Comedy
2000,39442871,80000000,5.3,-40557129,Fantasy
2000,34566746,80000000,7.3,-45433254,Drama
2000,34566746,80000000,7.3,-45433254,History
2000,34566746,80000000,7.3,-45433254,Thriller
2000,21471685,44000000,2.4,-22528315,Action
2000,21471685,44000000,2.4,-22528315,Adventure
2000,21471685,44000000,2.4,-22528315,Sci-Fi
2000,17473245,70000000,5.7,-52526755,Action
2000,17473245,70000000,5.7,-52526755,Sci-Fi
2000,17473245,70000000,5.7,-52526755,Thriller
2000,26000610,76000000,4.1,-49999390,Adventure
2000,26000610,76000000,4.1,-49999390,Animation
2000,26000610,76000000,4.1,-49999390,Comedy
2000,26000610,76000000,4.1,-49999390,Family
2000,26000610,76000000,4.1,-49999390,Fantasy
2000,157299717,75000000,7.4,82299717,Action
2000,157299717,75000000,7.4,82299717,Adventure
2000,157299717,75000000,7.4,82299717,Sci-Fi
2000,68473360,75000000,5.9,-6526640,Action
2000,68473360,75000000,5.9,-6526640,Adventure
2000,68473360,75000000,5.9,-6526640,Drama
2000,68473360,75000000,5.9,-6526640,Thriller
2000,22751979,75000000,6.6,-52248021,Action
2000,22751979,75000000,6.6,-52248021,Adventure
2000,22751979,75000000,6.6,-52248021,Animation
2000,22751979,75000000,6.6,-52248021,Family
2000,22751979,75000000,6.6,-52248021,Sci-Fi
2000,94999143,75000000,7.2,19999143,Drama
2000,94999143,75000000,7.2,19999143,Mystery
2000,94999143,75000000,7.2,19999143,Sci-Fi
2000,94999143,75000000,7.2,19999143,Thriller
2000,182805123,70000000,6.4,112805123,Comedy
2000,182805123,70000000,6.4,112805123,Fantasy
2000,182805123,70000000,6.4,112805123,Romance
2000,90454043,65000000,6.4,25454043,Action
2000,90454043,65000000,6.4,25454043,Adventure
2000,90454043,65000000,6.4,25454043,Thriller
2000,69688384,60000000,6.1,9688384,Comedy
2000,69688384,60000000,6.1,9688384,Family
2000,69688384,60000000,6.1,9688384,Fantasy
2000,32598931,65000000,6.2,-32401069,Action
2000,32598931,65000000,6.2,-32401069,Drama
2000,32598931,65000000,6.2,-32401069,Thriller
2000,10014234,65000000,5,-54985766,Comedy
2000,10014234,65000000,5,-54985766,Crime
2000,77086030,62000000,6.6,15086030,Action
2000,77086030,62000000,6.6,15086030,War
2000,75764085,60000000,6.7,15764085,Comedy
2000,75764085,60000000,6.7,15764085,Drama
2000,75764085,60000000,6.7,15764085,Fantasy
2000,75764085,60000000,6.7,15764085,Romance
2000,30695227,60000000,6.7,-29304773,Drama
2000,30695227,60000000,6.7,-29304773,Fantasy
2000,30695227,60000000,6.7,-29304773,Sport
2000,32522352,60000000,7.9,-27477648,Adventure
2000,32522352,60000000,7.9,-27477648,Comedy
2000,32522352,60000000,7.9,-27477648,Drama
2000,32522352,60000000,7.9,-27477648,Music
2000,14218868,65000000,4.8,-50781132,Horror
2000,14218868,65000000,4.8,-50781132,Sci-Fi
2000,14218868,65000000,4.8,-50781132,Thriller
2000,35231365,60000000,3.6,-24768635,Comedy
2000,35231365,60000000,3.6,-24768635,Family
2000,35231365,60000000,3.6,-24768635,Romance
2000,35231365,60000000,3.6,-24768635,Sci-Fi
2000,166225040,55000000,7,111225040,Comedy
2000,56932305,55000000,6.6,1932305,Action
2000,56932305,55000000,6.6,1932305,Adventure
2000,56932305,55000000,6.6,1932305,Comedy
2000,56932305,55000000,6.6,1932305,Western
2000,70327868,46000000,5.9,24327868,Action
2000,70327868,46000000,5.9,24327868,Crime
2000,70327868,46000000,5.9,24327868,Thriller
2000,90567722,51000000,6.5,39567722,Comedy
2000,125548685,52000000,7.3,73548685,Biography
2000,125548685,52000000,7.3,73548685,Drama
2000,44737059,50000000,6.5,-5262941,Comedy
2000,44737059,50000000,6.5,-5262941,Sport
2000,39778599,50000000,6.6,-10221401,Adventure
2000,39778599,50000000,6.6,-10221401,Drama
2000,39778599,50000000,6.6,-10221401,Thriller
2000,6291602,50000000,5.6,-43708398,Comedy
2000,6291602,50000000,5.6,-43708398,Sci-Fi
2000,124107476,48000000,7.6,76107476,Crime
2000,124107476,48000000,7.6,76107476,Drama
2000,124107476,48000000,7.6,76107476,Thriller
2000,37879996,48000000,6,-10120004,Comedy
2000,37879996,48000000,6,-10120004,Fantasy
2000,37879996,48000000,6,-10120004,Romance
2000,106807667,45000000,6.2,61807667,Action
2000,106807667,45000000,6.2,61807667,Comedy
2000,106807667,45000000,6.2,61807667,Crime
2000,106807667,45000000,6.2,61807667,Romance
2000,60786269,45000000,5.6,15786269,Comedy
2000,60786269,45000000,5.6,15786269,Drama
2000,60786269,45000000,5.6,15786269,Music
2000,60786269,45000000,5.6,15786269,Romance
2000,15527125,57000000,5.8,-41472875,Drama
2000,15527125,57000000,5.8,-41472875,Romance
2000,15527125,57000000,5.8,-41472875,Western
2000,51768623,43000000,7.3,8768623,Drama
2000,37035515,43000000,6,-5964485,Comedy
2000,37035515,43000000,6,-5964485,Drama
2000,106793915,45000000,7,61793915,Adventure
2000,106793915,45000000,7,61793915,Animation
2000,106793915,45000000,7,61793915,Comedy
2000,106793915,45000000,7,61793915,Drama
2000,106793915,45000000,7,61793915,Family
2000,89138076,40000000,5.5,49138076,Horror
2000,89138076,40000000,5.5,49138076,Mystery
2000,37752931,40000000,5.5,-2247069,Drama
2000,37752931,40000000,5.5,-2247069,Romance
2000,36037909,60000000,4.7,-23962091,Comedy
2000,36037909,60000000,4.7,-23962091,Drama
2000,33508922,40000000,7.2,-6491078,Drama
2000,30199105,40000000,5.7,-9800895,Action
2000,30199105,40000000,5.7,-9800895,Adventure
2000,30199105,40000000,5.7,-9800895,Crime
2000,30199105,40000000,5.7,-9800895,Thriller
2000,29374178,40000000,5.1,-10625822,Crime
2000,29374178,40000000,5.1,-10625822,Drama
2000,29374178,40000000,5.1,-10625822,Horror
2000,29374178,40000000,5.1,-10625822,Thriller
2000,14967182,40000000,5.1,-25032818,Action
2000,14967182,40000000,5.1,-25032818,Crime
2000,14967182,40000000,5.1,-25032818,Drama
2000,14967182,40000000,5.1,-25032818,Thriller
2000,23360779,34000000,5.7,-10639221,Action
2000,23360779,34000000,5.7,-10639221,Adventure
2000,23360779,34000000,5.7,-10639221,Crime
2000,23360779,34000000,5.7,-10639221,Drama
2000,23360779,34000000,5.7,-10639221,Family
2000,23360779,34000000,5.7,-10639221,Fantasy
2000,23360779,34000000,5.7,-10639221,Romance
2000,23360779,34000000,5.7,-10639221,Thriller
2000,2954405,36000000,5.3,-33045595,Biography
2000,2954405,36000000,5.3,-33045595,Comedy
2000,2954405,36000000,5.3,-33045595,Romance
2000,61280963,33000000,6.3,28280963,Horror
2000,61280963,33000000,6.3,28280963,Sci-Fi
2000,61280963,33000000,6.3,28280963,Thriller
2000,19389454,55000000,7.4,-35610546,Comedy
2000,19389454,55000000,7.4,-35610546,Drama
2000,6543194,34000000,5.6,-27456806,Adventure
2000,6543194,34000000,5.6,-27456806,Drama
2000,6543194,34000000,5.6,-27456806,Romance
2000,117559438,30000000,5.1,87559438,Action
2000,117559438,30000000,5.1,87559438,Comedy
2000,117559438,30000000,5.1,87559438,Crime
2000,28927720,33000000,5.3,-4072280,Crime
2000,28927720,33000000,5.3,-4072280,Horror
2000,28927720,33000000,5.3,-4072280,Mystery
2000,28927720,33000000,5.3,-4072280,Thriller
2000,48814909,32000000,7.2,16814909,Biography
2000,48814909,32000000,7.2,16814909,Drama
2000,44983704,31000000,7.3,13983704,Crime
2000,44983704,31000000,7.3,13983704,Drama
2000,44983704,31000000,7.3,13983704,Mystery
2000,44983704,31000000,7.3,13983704,Sci-Fi
2000,44983704,31000000,7.3,13983704,Thriller
2000,115648585,30000000,7.8,85648585,Biography
2000,115648585,30000000,7.8,85648585,Drama
2000,115648585,30000000,7.8,85648585,Sport
2000,76501438,30000000,6.1,46501438,Adventure
2000,76501438,30000000,6.1,46501438,Animation
2000,76501438,30000000,6.1,46501438,Comedy
2000,76501438,30000000,6.1,46501438,Family
2000,76501438,30000000,6.1,46501438,Romance
2000,37036404,30000000,6.4,7036404,Comedy
2000,37036404,30000000,6.4,7036404,Drama
2000,37036404,30000000,6.4,7036404,Romance
2000,33000377,28000000,4.9,5000377,Action
2000,33000377,28000000,4.9,5000377,Fantasy
2000,33000377,28000000,4.9,5000377,Horror
2000,33000377,28000000,4.9,5000377,Thriller
2000,16779636,28000000,4.8,-11220364,Drama
2000,16779636,28000000,4.8,-11220364,Horror
2000,16779636,28000000,4.8,-11220364,Thriller
2000,45506619,26000000,7.8,19506619,Adventure
2000,45506619,26000000,7.8,19506619,Comedy
2000,45506619,26000000,7.8,19506619,Crime
2000,45506619,26000000,7.8,19506619,Music
2000,71309760,25000000,7.3,46309760,Drama
2000,71309760,25000000,7.3,46309760,Romance
2000,55973336,25000000,6.1,30973336,Action
2000,55973336,25000000,6.1,30973336,Crime
2000,55973336,25000000,6.1,30973336,Thriller
2000,14983572,25000000,4.7,-10016428,Comedy
2000,14983572,25000000,4.7,-10016428,Drama
2000,14983572,25000000,4.7,-10016428,Romance
2000,57262492,24000000,6.7,33262492,Comedy
2000,57262492,24000000,6.7,33262492,Crime
2000,32662299,24000000,6.9,8662299,Comedy
2000,32662299,24000000,6.9,8662299,Drama
2000,32662299,24000000,6.9,8662299,Romance
2000,25167270,24000000,6.3,1167270,Comedy
2000,25167270,24000000,6.3,1167270,Crime
2000,25167270,24000000,6.3,1167270,Drama
2000,12372410,24000000,5.3,-11627590,Comedy
2000,12372410,24000000,5.3,-11627590,Sport
2000,53302314,23000000,6.7,30302314,Horror
2000,53302314,23000000,6.7,30302314,Thriller
2000,39235088,23000000,7.1,16235088,Horror
2000,39235088,23000000,7.1,16235088,Sci-Fi
2000,13019253,23000000,5.6,-9980747,Comedy
2000,13019253,23000000,5.6,-9980747,Crime
2000,13555988,22000000,5.7,-8444012,Adventure
2000,13555988,22000000,5.7,-8444012,Comedy
2000,13555988,22000000,5.7,-8444012,Family
2000,13555988,22000000,5.7,-8444012,Fantasy
2000,45542421,30000000,6.3,15542421,Animation
2000,45542421,30000000,6.3,15542421,Comedy
2000,45542421,30000000,6.3,15542421,Drama
2000,45542421,30000000,6.3,15542421,Family
2000,45542421,30000000,6.3,15542421,Musical
2000,27277055,20000000,7.6,7277055,Comedy
2000,27277055,20000000,7.6,7277055,Drama
2000,27277055,20000000,7.6,7277055,Music
2000,27277055,20000000,7.6,7277055,Romance
2000,15464026,20000000,5.3,-4535974,Comedy
2000,15464026,20000000,5.3,-4535974,Romance
2000,882710,24000000,6.4,-23117290,Crime
2000,882710,24000000,6.4,-23117290,Drama
2000,882710,24000000,6.4,-23117290,Romance
2000,882710,24000000,6.4,-23117290,Thriller
2000,15911333,19000000,3.6,-3088667,Adventure
2000,15911333,19000000,3.6,-3088667,Comedy
2000,15911333,19000000,3.6,-3088667,Drama
2000,15911333,19000000,3.6,-3088667,Family
2000,15911333,19000000,3.6,-3088667,Fantasy
2000,17071230,18000000,6.7,-928770,Comedy
2000,17071230,18000000,6.7,-928770,Crime
2000,17174870,18000000,6.7,-825130,Drama
2000,17174870,18000000,6.7,-825130,Music
2000,17174870,18000000,6.7,-825130,Romance
2000,68525609,15600000,6.5,52925609,Comedy
2000,20627372,16000000,5.3,4627372,Comedy
2000,20627372,16000000,5.3,4627372,Drama
2000,20627372,16000000,5.3,4627372,Romance
2000,15427192,16000000,5.6,-572808,Comedy
2000,15427192,16000000,5.6,-572808,Crime
2000,15427192,16000000,5.6,-572808,Mystery
2000,4734235,15000000,6,-10265765,Comedy
2000,4734235,15000000,6,-10265765,Drama
2000,4734235,15000000,6,-10265765,Music
2000,128067808,15000000,7.9,113067808,Action
2000,128067808,15000000,7.9,113067808,Drama
2000,128067808,15000000,7.9,113067808,Romance
2000,35007180,15000000,5.6,20007180,Action
2000,35007180,15000000,5.6,20007180,Crime
2000,35007180,15000000,5.6,20007180,Drama
2000,35007180,15000000,5.6,20007180,Thriller
2000,33771174,15000000,6.8,18771174,Comedy
2000,33771174,15000000,6.8,18771174,Drama
2000,33771174,15000000,6.8,18771174,Romance
2000,27441122,15000000,7.2,12441122,Drama
2000,27441122,15000000,7.2,12441122,Romance
2000,27441122,15000000,7.2,12441122,Sport
2000,26421314,15000000,4,11421314,Adventure
2000,26421314,15000000,4,11421314,Fantasy
2000,26421314,15000000,4,11421314,Horror
2000,26421314,15000000,4,11421314,Mystery
2000,26421314,15000000,4,11421314,Thriller
2000,21468807,14000000,4.1,7468807,Horror
2000,21468807,14000000,4.1,7468807,Mystery
2000,21468807,14000000,4.1,7468807,Thriller
2000,12801190,15000000,4.6,-2198810,Action
2000,12801190,15000000,4.6,-2198810,Adventure
2000,12801190,15000000,4.6,-2198810,Fantasy
2000,12801190,15000000,4.6,-2198810,Sci-Fi
2000,10494147,15000000,5.1,-4505853,Drama
2000,10494147,15000000,5.1,-4505853,Romance
2000,8735529,15000000,5.5,-6264471,Comedy
2000,8735529,15000000,5.5,-6264471,Drama
2000,8735529,15000000,5.5,-6264471,Romance
2000,5217498,15000000,4.6,-9782502,Drama
2000,5217498,15000000,4.6,-9782502,Mystery
2000,5217498,15000000,4.6,-9782502,Thriller
2000,5108820,24000000,5.9,-18891180,Drama
2000,5108820,24000000,5.9,-18891180,Mystery
2000,5108820,24000000,5.9,-18891180,Thriller
2000,7060876,13500000,7.4,-6439124,Biography
2000,7060876,13500000,7.4,-6439124,Drama
2000,46729374,13000000,5.5,33729374,Comedy
2000,46729374,13000000,5.5,33729374,Mystery
2000,60008303,13000000,4.9,47008303,Adventure
2000,60008303,13000000,4.9,47008303,Comedy
2000,60008303,13000000,4.9,47008303,Family
2000,3058380,100000000,7.3,-96941620,Drama
2000,3058380,100000000,7.3,-96941620,Romance
2000,403932,20000000,6.5,-19596068,Drama
2000,403932,20000000,6.5,-19596068,Romance
2000,403932,20000000,6.5,-19596068,Western
2000,4157491,12800000,8,-8642509,Crime
2000,4157491,12800000,8,-8642509,Drama
2000,4157491,12800000,8,-8642509,Musical
2000,6982680,10000000,5.7,-3017320,Comedy
2000,6982680,10000000,5.7,-3017320,Crime
2000,447750,10000000,7.2,-9552250,Crime
2000,447750,10000000,7.2,-9552250,Drama
2000,447750,10000000,7.2,-9552250,Thriller
2000,30093107,6000000,8.3,24093107,Comedy
2000,30093107,6000000,8.3,24093107,Crime
2000,13592872,11000000,5.1,2592872,Comedy
2000,68353550,10000000,5.9,58353550,Comedy
2000,68353550,10000000,5.9,58353550,Sport
2000,30093107,6000000,8.3,24093107,Comedy
2000,30093107,6000000,8.3,24093107,Crime
2000,3041803,10000000,7.1,-6958197,Drama
2000,3041803,10000000,7.1,-6958197,Romance
2000,2185266,10000000,6.5,-7814734,Comedy
2000,2185266,10000000,6.5,-7814734,Drama
2000,2185266,10000000,6.5,-7814734,Music
2000,1631839,10000000,5.7,-8368161,Comedy
2000,1631839,10000000,5.7,-8368161,Crime
2000,1631839,10000000,5.7,-8368161,Romance
2000,1276984,10000000,6.2,-8723016,Comedy
2000,1276984,10000000,6.2,-8723016,Crime
2000,1276984,10000000,6.2,-8723016,Thriller
2000,57176582,9500000,6.1,47676582,Comedy
2000,20035310,9000000,4.9,11035310,Comedy
2000,20035310,9000000,4.9,11035310,Drama
2000,20035310,9000000,4.9,11035310,Romance
2000,17804273,20000000,7,-2195727,Drama
2000,17804273,20000000,7,-2195727,Thriller
2000,16938179,8000000,7,8938179,Crime
2000,16938179,8000000,7,8938179,Drama
2000,16938179,8000000,7,8938179,Thriller
2000,6047856,8500000,6.7,-2452144,Action
2000,6047856,8500000,6.7,-2452144,Crime
2000,6047856,8500000,6.7,-2452144,Drama
2000,6047856,8500000,6.7,-2452144,Thriller
2000,15047419,7000000,7.6,8047419,Crime
2000,15047419,7000000,7.6,8047419,Drama
2000,8279017,8000000,6.9,279017,Drama
2000,8279017,8000000,6.9,279017,Horror
2000,5018450,8000000,5.3,-2981550,Comedy
2000,5018450,8000000,5.3,-2981550,Fantasy
2000,5018450,8000000,5.3,-2981550,Romance
2000,34099640,5000000,7,29099640,Drama
2000,34099640,5000000,7,29099640,Family
2000,34099640,5000000,7,29099640,Sport
2000,403932,20000000,6.5,-19596068,Drama
2000,403932,20000000,6.5,-19596068,Romance
2000,403932,20000000,6.5,-19596068,Western
2000,64148,6500000,7.3,-6435852,Drama
2000,18621249,6000000,7.5,12621249,Comedy
2000,8596914,6000000,7,2596914,Biography
2000,8596914,6000000,7,2596914,Drama
2000,25530884,9000000,8.5,16530884,Mystery
2000,25530884,9000000,8.5,16530884,Thriller
2000,21994911,5000000,7.7,16994911,Drama
2000,21994911,5000000,7.7,16994911,Music
2000,9628751,5000000,5.9,4628751,Action
2000,9628751,5000000,5.9,4628751,Adventure
2000,9628751,5000000,5.9,4628751,Animation
2000,9628751,5000000,5.9,4628751,Family
2000,9628751,5000000,5.9,4628751,Sci-Fi
2000,3609278,4500000,8.4,-890722,Drama
2000,9821335,6000000,4,3821335,Comedy
2000,265107,1500000,6.3,-1234893,Comedy
2000,265107,1500000,6.3,-1234893,Horror
2000,265107,1500000,6.3,-1234893,Mystery
2000,75078,14000000,6.3,-13924922,Comedy
2000,38168022,3000000,6.6,35168022,Comedy
2000,38168022,3000000,6.6,35168022,Documentary
2000,4142507,3000000,4.4,1142507,Comedy
2000,4142507,3000000,4.4,1142507,Romance
2000,5725,8400000,6.1,-8394275,Horror
2000,5725,8400000,6.1,-8394275,Thriller
2000,5383834,2000000,8.1,3383834,Drama
2000,5383834,2000000,8.1,3383834,Thriller
2000,3050934,1800000,7.3,1250934,Drama
2000,3050934,1800000,7.3,1250934,Music
2000,1221261,1500000,7.9,-278739,Crime
2000,1221261,1500000,7.9,-278739,Drama
2000,1221261,1500000,7.9,-278739,Thriller
2000,9180275,1200000,7.7,7980275,Drama
2000,1744858,1000000,7,744858,Comedy
2000,1744858,1000000,7,744858,Drama
2000,1744858,1000000,7,744858,Romance
2000,1744858,1000000,7,744858,Sport
2000,610991,1000000,6.2,-389009,Drama
2000,610991,1000000,6.2,-389009,Romance
2000,428535,1000000,3.6,-571465,Comedy
2000,428535,1000000,3.6,-571465,Romance
2000,12996,1000000,6,-987004,Action
2000,12996,1000000,6,-987004,Comedy
2000,12996,1000000,6,-987004,Fantasy
2000,12996,1000000,6,-987004,Sci-Fi
2000,171988,600000,5.6,-428012,Action
2000,171988,600000,5.6,-428012,Crime
2000,171988,600000,5.6,-428012,Drama
2000,1114943,500000,6.5,614943,Drama
2000,1114943,500000,6.5,614943,Music
2000,1050600,250000,6.6,800600,Comedy
2000,1050600,250000,6.6,800600,Drama
2000,1027119,225000,7,802119,Drama
2000,2882062,150000,6.3,2732062,Comedy
2000,2882062,150000,6.3,2732062,Drama
2000,2882062,150000,6.3,2732062,Romance
2000,241816,42000,7.5,199816,Drama
2000,673780,10000,7.5,663780,Drama
